"","check_in_date","over_nbookings","over_canceled","over_booking_arrivals","booking_n","booking_canceled","booking_arrivals","iter"
"1",2017-03-25,138,48,90,100,41,59,1
"2",2017-03-26,126,32,94,100,24,76,1
"3",2017-03-27,121,24,97,100,22,78,1
"4",2017-03-28,125,18,107,100,30,70,1
"5",2017-03-29,120,18,102,100,19,81,1
"6",2017-03-30,132,52,80,100,38,62,1
"7",2017-03-31,145,69,76,100,46,54,1
"8",2017-04-01,126,47,79,100,47,53,1
"9",2017-04-02,126,22,104,100,30,70,1
"10",2017-04-03,130,40,90,100,48,52,1
"11",2017-04-04,158,96,62,100,62,38,1
"12",2017-04-05,141,84,57,100,41,59,1
"13",2017-04-06,167,104,63,100,68,32,1
"14",2017-04-07,124,42,82,100,39,61,1
"15",2017-04-08,129,66,63,100,50,50,1
"16",2017-04-09,140,69,71,100,42,58,1
"17",2017-04-10,125,42,83,100,37,63,1
"18",2017-04-11,127,35,92,100,24,76,1
"19",2017-04-12,129,37,92,100,36,64,1
"20",2017-04-13,137,75,62,100,60,40,1
"21",2017-04-14,128,67,61,100,55,45,1
"22",2017-04-15,142,81,61,100,65,35,1
"23",2017-04-16,137,64,73,100,49,51,1
"24",2017-04-17,127,51,76,100,41,59,1
"25",2017-04-18,129,48,81,100,36,64,1
"26",2017-04-19,123,38,85,100,16,84,1
"27",2017-04-20,134,58,76,100,34,66,1
"28",2017-04-21,147,92,55,100,61,39,1
"29",2017-04-22,171,131,40,100,76,24,1
"30",2017-04-23,144,59,85,100,36,64,1
"31",2017-04-24,125,35,90,100,24,76,1
"32",2017-04-25,135,40,95,100,42,58,1
"33",2017-04-26,175,141,34,100,79,21,1
"34",2017-04-27,142,76,66,100,53,47,1
"35",2017-04-28,127,47,80,100,42,58,1
"36",2017-04-29,140,84,56,100,54,46,1
"37",2017-04-30,124,41,83,100,33,67,1
"38",2017-05-01,137,66,71,100,48,52,1
"39",2017-05-02,123,19,104,100,22,78,1
"40",2017-05-03,149,105,44,100,61,39,1
"41",2017-05-04,161,108,53,100,74,26,1
"42",2017-05-05,131,62,69,100,44,56,1
"43",2017-05-06,140,61,79,100,55,45,1
"44",2017-05-07,126,50,76,100,45,55,1
"45",2017-05-08,134,76,58,100,47,53,1
"46",2017-05-09,135,53,82,100,27,73,1
"47",2017-05-10,126,59,67,100,50,50,1
"48",2017-05-11,133,54,79,100,44,56,1
"49",2017-05-12,127,50,77,100,46,54,1
"50",2017-05-13,140,77,63,100,44,56,1
"51",2017-05-14,118,21,97,100,15,85,1
"52",2017-05-15,168,118,50,100,78,22,1
"53",2017-05-16,131,50,81,100,48,52,1
"54",2017-05-17,126,37,89,100,22,78,1
"55",2017-05-18,132,53,79,100,33,67,1
"56",2017-05-19,168,115,53,100,76,24,1
"57",2017-05-20,145,96,49,100,59,41,1
"58",2017-05-21,123,43,80,100,27,73,1
"59",2017-05-22,122,54,68,100,42,58,1
"60",2017-05-23,131,50,81,100,31,69,1
"61",2017-05-24,134,63,71,100,54,46,1
"62",2017-05-25,154,73,81,100,37,63,1
"63",2017-05-26,135,65,70,100,46,54,1
"64",2017-05-27,129,43,86,100,45,55,1
"65",2017-05-28,143,67,76,100,44,56,1
"66",2017-05-29,126,40,86,100,21,79,1
"67",2017-05-30,171,122,49,100,61,39,1
"68",2017-05-31,138,57,81,100,40,60,1
"69",2017-06-01,147,83,64,100,50,50,1
"70",2017-06-02,143,64,79,100,46,54,1
"71",2017-06-03,146,71,75,100,43,57,1
"72",2017-06-04,136,52,84,100,39,61,1
"73",2017-06-05,125,38,87,100,41,59,1
"74",2017-06-06,126,40,86,100,38,62,1
"75",2017-06-07,141,62,79,100,51,49,1
"76",2017-06-08,160,104,56,100,63,37,1
"77",2017-06-09,148,52,96,100,44,56,1
"78",2017-06-10,128,46,82,100,30,70,1
"79",2017-06-11,128,55,73,100,42,58,1
"80",2017-06-12,135,56,79,100,45,55,1
"81",2017-06-13,131,41,90,100,31,69,1
"82",2017-06-14,157,68,89,100,38,62,1
"83",2017-06-15,138,52,86,100,33,67,1
"84",2017-06-16,143,81,62,100,57,43,1
"85",2017-06-17,167,100,67,100,58,42,1
"86",2017-06-18,129,37,92,100,41,59,1
"87",2017-06-19,136,65,71,100,40,60,1
"88",2017-06-20,125,52,73,100,43,57,1
"89",2017-06-21,148,86,62,100,51,49,1
"90",2017-06-22,127,45,82,100,35,65,1
"91",2017-06-23,148,70,78,100,55,45,1
"92",2017-06-24,150,77,73,100,38,62,1
"93",2017-06-25,146,24,122,100,14,86,1
"94",2017-06-26,145,78,67,100,48,52,1
"95",2017-06-27,137,70,67,100,48,52,1
"96",2017-06-28,146,74,72,100,55,45,1
"97",2017-06-29,129,58,71,100,48,52,1
"98",2017-06-30,137,52,85,100,49,51,1
"99",2017-07-01,150,54,96,100,37,63,1
"100",2017-07-02,128,37,91,100,37,63,1
"101",2017-07-03,132,48,84,100,39,61,1
"102",2017-07-04,150,34,116,100,17,83,1
"103",2017-07-05,142,73,69,100,54,46,1
"104",2017-07-06,130,36,94,100,36,64,1
"105",2017-07-07,137,67,70,100,45,55,1
"106",2017-07-08,139,43,96,100,35,65,1
"107",2017-07-09,141,75,66,100,43,57,1
"108",2017-07-10,130,47,83,100,27,73,1
"109",2017-07-11,140,65,75,100,39,61,1
"110",2017-07-12,152,59,93,100,33,67,1
"111",2017-07-13,150,48,102,100,29,71,1
"112",2017-07-14,131,51,80,100,36,64,1
"113",2017-07-15,140,52,88,100,32,68,1
"114",2017-07-16,133,35,98,100,32,68,1
"115",2017-07-17,136,53,83,100,35,65,1
"116",2017-07-18,146,51,95,100,48,52,1
"117",2017-07-19,141,28,113,100,17,83,1
"118",2017-07-20,137,49,88,100,35,65,1
"119",2017-07-21,127,43,84,100,36,64,1
"120",2017-07-22,146,39,107,100,34,66,1
"121",2017-07-23,146,60,86,100,46,54,1
"122",2017-07-24,132,39,93,100,38,62,1
"123",2017-07-25,139,52,87,100,40,60,1
"124",2017-07-26,162,75,87,100,53,47,1
"125",2017-07-27,134,56,78,100,36,64,1
"126",2017-07-28,136,73,63,100,64,36,1
"127",2017-07-29,143,67,76,100,54,46,1
"128",2017-07-30,130,44,86,100,31,69,1
"129",2017-07-31,137,42,95,100,31,69,1
"130",2017-08-01,138,65,73,100,47,53,1
"131",2017-08-02,133,35,98,100,30,70,1
"132",2017-08-03,128,45,83,100,35,65,1
"133",2017-08-04,138,33,105,100,28,72,1
"134",2017-08-05,137,57,80,100,42,58,1
"135",2017-08-06,135,47,88,100,36,64,1
"136",2017-08-07,133,51,82,100,28,72,1
"137",2017-08-08,147,72,75,100,43,57,1
"138",2017-08-09,141,44,97,100,38,62,1
"139",2017-08-10,134,58,76,100,40,60,1
"140",2017-08-11,136,57,79,100,38,62,1
"141",2017-08-12,144,53,91,100,34,66,1
"142",2017-08-13,133,54,79,100,43,57,1
"143",2017-08-14,131,48,83,100,29,71,1
"144",2017-08-15,138,57,81,100,44,56,1
"145",2017-08-16,134,63,71,100,53,47,1
"146",2017-08-17,134,54,80,100,36,64,1
"147",2017-08-18,133,65,68,100,43,57,1
"148",2017-08-19,139,64,75,100,39,61,1
"149",2017-08-20,128,30,98,100,22,78,1
"150",2017-08-21,135,51,84,100,33,67,1
"151",2017-08-22,131,37,94,100,39,61,1
"152",2017-08-23,128,35,93,100,25,75,1
"153",2017-08-24,129,53,76,100,30,70,1
"154",2017-08-25,150,40,110,100,26,74,1
"155",2017-08-26,152,66,86,100,43,57,1
"156",2017-08-27,125,33,92,100,34,66,1
"157",2017-08-28,131,30,101,100,16,84,1
"158",2017-08-29,138,52,86,100,31,69,1
"159",2017-08-30,134,36,98,100,26,74,1
"160",2017-08-31,131,53,78,100,36,64,1
"161",2017-03-25,139,61,78,100,47,53,2
"162",2017-03-26,127,40,87,100,29,71,2
"163",2017-03-27,121,16,105,100,20,80,2
"164",2017-03-28,125,35,90,100,29,71,2
"165",2017-03-29,119,22,97,100,14,86,2
"166",2017-03-30,128,49,79,100,45,55,2
"167",2017-03-31,145,76,69,100,45,55,2
"168",2017-04-01,126,55,71,100,44,56,2
"169",2017-04-02,126,25,101,100,20,80,2
"170",2017-04-03,137,50,87,100,46,54,2
"171",2017-04-04,164,107,57,100,50,50,2
"172",2017-04-05,133,64,69,100,47,53,2
"173",2017-04-06,165,107,58,100,64,36,2
"174",2017-04-07,127,51,76,100,34,66,2
"175",2017-04-08,127,51,76,100,56,44,2
"176",2017-04-09,147,82,65,100,60,40,2
"177",2017-04-10,124,43,81,100,37,63,2
"178",2017-04-11,125,35,90,100,29,71,2
"179",2017-04-12,134,58,76,100,36,64,2
"180",2017-04-13,139,67,72,100,53,47,2
"181",2017-04-14,126,52,74,100,47,53,2
"182",2017-04-15,140,90,50,100,70,30,2
"183",2017-04-16,134,58,76,100,49,51,2
"184",2017-04-17,128,35,93,100,26,74,2
"185",2017-04-18,128,56,72,100,40,60,2
"186",2017-04-19,122,35,87,100,23,77,2
"187",2017-04-20,141,60,81,100,39,61,2
"188",2017-04-21,153,91,62,100,64,36,2
"189",2017-04-22,168,108,60,100,72,28,2
"190",2017-04-23,145,69,76,100,43,57,2
"191",2017-04-24,123,30,93,100,21,79,2
"192",2017-04-25,136,54,82,100,39,61,2
"193",2017-04-26,175,137,38,100,83,17,2
"194",2017-04-27,143,70,73,100,57,43,2
"195",2017-04-28,127,60,67,100,35,65,2
"196",2017-04-29,142,94,48,100,63,37,2
"197",2017-04-30,125,42,83,100,31,69,2
"198",2017-05-01,135,67,68,100,46,54,2
"199",2017-05-02,124,37,87,100,26,74,2
"200",2017-05-03,150,105,45,100,65,35,2
"201",2017-05-04,157,101,56,100,62,38,2
"202",2017-05-05,129,59,70,100,43,57,2
"203",2017-05-06,143,77,66,100,54,46,2
"204",2017-05-07,125,41,84,100,41,59,2
"205",2017-05-08,130,66,64,100,45,55,2
"206",2017-05-09,131,55,76,100,35,65,2
"207",2017-05-10,130,63,67,100,45,55,2
"208",2017-05-11,128,48,80,100,40,60,2
"209",2017-05-12,131,59,72,100,47,53,2
"210",2017-05-13,138,58,80,100,53,47,2
"211",2017-05-14,119,19,100,100,20,80,2
"212",2017-05-15,170,124,46,100,70,30,2
"213",2017-05-16,135,62,73,100,47,53,2
"214",2017-05-17,130,30,100,100,25,75,2
"215",2017-05-18,139,70,69,100,33,67,2
"216",2017-05-19,166,117,49,100,78,22,2
"217",2017-05-20,145,85,60,100,53,47,2
"218",2017-05-21,124,33,91,100,28,72,2
"219",2017-05-22,121,51,70,100,43,57,2
"220",2017-05-23,130,41,89,100,26,74,2
"221",2017-05-24,137,67,70,100,49,51,2
"222",2017-05-25,156,63,93,100,53,47,2
"223",2017-05-26,136,65,71,100,51,49,2
"224",2017-05-27,130,53,77,100,47,53,2
"225",2017-05-28,145,64,81,100,37,63,2
"226",2017-05-29,123,30,93,100,26,74,2
"227",2017-05-30,162,111,51,100,65,35,2
"228",2017-05-31,139,58,81,100,36,64,2
"229",2017-06-01,148,82,66,100,50,50,2
"230",2017-06-02,145,62,83,100,52,48,2
"231",2017-06-03,143,54,89,100,43,57,2
"232",2017-06-04,141,61,80,100,43,57,2
"233",2017-06-05,122,39,83,100,31,69,2
"234",2017-06-06,125,29,96,100,29,71,2
"235",2017-06-07,141,64,77,100,37,63,2
"236",2017-06-08,162,116,46,100,73,27,2
"237",2017-06-09,143,64,79,100,44,56,2
"238",2017-06-10,125,49,76,100,50,50,2
"239",2017-06-11,127,48,79,100,48,52,2
"240",2017-06-12,133,58,75,100,38,62,2
"241",2017-06-13,129,36,93,100,39,61,2
"242",2017-06-14,155,59,96,100,38,62,2
"243",2017-06-15,140,49,91,100,41,59,2
"244",2017-06-16,139,58,81,100,59,41,2
"245",2017-06-17,164,93,71,100,57,43,2
"246",2017-06-18,128,38,90,100,46,54,2
"247",2017-06-19,138,52,86,100,32,68,2
"248",2017-06-20,131,57,74,100,37,63,2
"249",2017-06-21,146,80,66,100,53,47,2
"250",2017-06-22,128,41,87,100,42,58,2
"251",2017-06-23,149,82,67,100,53,47,2
"252",2017-06-24,151,75,76,100,51,49,2
"253",2017-06-25,145,17,128,100,16,84,2
"254",2017-06-26,139,62,77,100,59,41,2
"255",2017-06-27,135,65,70,100,52,48,2
"256",2017-06-28,148,79,69,100,37,63,2
"257",2017-06-29,130,57,73,100,51,49,2
"258",2017-06-30,145,58,87,100,35,65,2
"259",2017-07-01,150,56,94,100,37,63,2
"260",2017-07-02,129,32,97,100,37,63,2
"261",2017-07-03,132,42,90,100,40,60,2
"262",2017-07-04,151,35,116,100,23,77,2
"263",2017-07-05,140,79,61,100,53,47,2
"264",2017-07-06,130,41,89,100,43,57,2
"265",2017-07-07,135,64,71,100,53,47,2
"266",2017-07-08,134,44,90,100,30,70,2
"267",2017-07-09,139,58,81,100,45,55,2
"268",2017-07-10,130,54,76,100,36,64,2
"269",2017-07-11,131,42,89,100,44,56,2
"270",2017-07-12,155,67,88,100,45,55,2
"271",2017-07-13,148,47,101,100,22,78,2
"272",2017-07-14,130,52,78,100,33,67,2
"273",2017-07-15,137,53,84,100,37,63,2
"274",2017-07-16,135,42,93,100,25,75,2
"275",2017-07-17,138,49,89,100,33,67,2
"276",2017-07-18,141,40,101,100,32,68,2
"277",2017-07-19,139,23,116,100,28,72,2
"278",2017-07-20,135,45,90,100,33,67,2
"279",2017-07-21,126,28,98,100,44,56,2
"280",2017-07-22,149,44,105,100,36,64,2
"281",2017-07-23,148,70,78,100,44,56,2
"282",2017-07-24,129,42,87,100,30,70,2
"283",2017-07-25,147,70,77,100,33,67,2
"284",2017-07-26,163,80,83,100,59,41,2
"285",2017-07-27,135,40,95,100,32,68,2
"286",2017-07-28,134,65,69,100,56,44,2
"287",2017-07-29,145,63,82,100,48,52,2
"288",2017-07-30,130,36,94,100,17,83,2
"289",2017-07-31,139,57,82,100,47,53,2
"290",2017-08-01,140,62,78,100,51,49,2
"291",2017-08-02,135,46,89,100,30,70,2
"292",2017-08-03,129,49,80,100,38,62,2
"293",2017-08-04,139,41,98,100,28,72,2
"294",2017-08-05,138,55,83,100,36,64,2
"295",2017-08-06,135,41,94,100,33,67,2
"296",2017-08-07,132,45,87,100,34,66,2
"297",2017-08-08,149,72,77,100,57,43,2
"298",2017-08-09,140,57,83,100,39,61,2
"299",2017-08-10,133,44,89,100,48,52,2
"300",2017-08-11,134,56,78,100,47,53,2
"301",2017-08-12,147,43,104,100,34,66,2
"302",2017-08-13,135,51,84,100,30,70,2
"303",2017-08-14,132,42,90,100,31,69,2
"304",2017-08-15,142,58,84,100,38,62,2
"305",2017-08-16,132,58,74,100,54,46,2
"306",2017-08-17,138,63,75,100,48,52,2
"307",2017-08-18,131,57,74,100,49,51,2
"308",2017-08-19,139,70,69,100,51,49,2
"309",2017-08-20,128,29,99,100,26,74,2
"310",2017-08-21,134,43,91,100,30,70,2
"311",2017-08-22,132,39,93,100,25,75,2
"312",2017-08-23,130,46,84,100,31,69,2
"313",2017-08-24,130,51,79,100,29,71,2
"314",2017-08-25,152,37,115,100,23,77,2
"315",2017-08-26,145,55,90,100,32,68,2
"316",2017-08-27,123,41,82,100,21,79,2
"317",2017-08-28,129,24,105,100,21,79,2
"318",2017-08-29,137,48,89,100,40,60,2
"319",2017-08-30,132,30,102,100,24,76,2
"320",2017-08-31,133,53,80,100,28,72,2
"321",2017-03-25,142,64,78,100,41,59,3
"322",2017-03-26,124,35,89,100,28,72,3
"323",2017-03-27,120,25,95,100,18,82,3
"324",2017-03-28,126,31,95,100,24,76,3
"325",2017-03-29,120,26,94,100,18,82,3
"326",2017-03-30,133,49,84,100,43,57,3
"327",2017-03-31,144,70,74,100,45,55,3
"328",2017-04-01,125,51,74,100,38,62,3
"329",2017-04-02,126,31,95,100,18,82,3
"330",2017-04-03,132,53,79,100,39,61,3
"331",2017-04-04,152,87,65,100,60,40,3
"332",2017-04-05,143,72,71,100,53,47,3
"333",2017-04-06,164,108,56,100,65,35,3
"334",2017-04-07,126,42,84,100,39,61,3
"335",2017-04-08,130,66,64,100,41,59,3
"336",2017-04-09,153,96,57,100,47,53,3
"337",2017-04-10,125,43,82,100,40,60,3
"338",2017-04-11,127,23,104,100,33,67,3
"339",2017-04-12,132,50,82,100,37,63,3
"340",2017-04-13,135,65,70,100,55,45,3
"341",2017-04-14,125,50,75,100,45,55,3
"342",2017-04-15,144,84,60,100,60,40,3
"343",2017-04-16,139,67,72,100,38,62,3
"344",2017-04-17,129,42,87,100,36,64,3
"345",2017-04-18,134,64,70,100,43,57,3
"346",2017-04-19,120,30,90,100,21,79,3
"347",2017-04-20,130,55,75,100,47,53,3
"348",2017-04-21,146,83,63,100,60,40,3
"349",2017-04-22,174,122,52,100,83,17,3
"350",2017-04-23,147,70,77,100,50,50,3
"351",2017-04-24,123,35,88,100,25,75,3
"352",2017-04-25,140,57,83,100,37,63,3
"353",2017-04-26,181,144,37,100,80,20,3
"354",2017-04-27,141,68,73,100,50,50,3
"355",2017-04-28,127,59,68,100,40,60,3
"356",2017-04-29,140,74,66,100,60,40,3
"357",2017-04-30,126,39,87,100,35,65,3
"358",2017-05-01,132,61,71,100,52,48,3
"359",2017-05-02,122,30,92,100,31,69,3
"360",2017-05-03,148,105,43,100,61,39,3
"361",2017-05-04,157,99,58,100,65,35,3
"362",2017-05-05,132,59,73,100,48,52,3
"363",2017-05-06,147,82,65,100,51,49,3
"364",2017-05-07,125,47,78,100,41,59,3
"365",2017-05-08,129,70,59,100,47,53,3
"366",2017-05-09,133,47,86,100,40,60,3
"367",2017-05-10,132,64,68,100,40,60,3
"368",2017-05-11,132,58,74,100,39,61,3
"369",2017-05-12,127,59,68,100,36,64,3
"370",2017-05-13,142,62,80,100,43,57,3
"371",2017-05-14,118,17,101,100,14,86,3
"372",2017-05-15,167,130,37,100,69,31,3
"373",2017-05-16,130,50,80,100,57,43,3
"374",2017-05-17,126,37,89,100,32,68,3
"375",2017-05-18,129,51,78,100,42,58,3
"376",2017-05-19,171,125,46,100,82,18,3
"377",2017-05-20,138,69,69,100,57,43,3
"378",2017-05-21,124,42,82,100,36,64,3
"379",2017-05-22,123,56,67,100,44,56,3
"380",2017-05-23,132,47,85,100,26,74,3
"381",2017-05-24,137,59,78,100,44,56,3
"382",2017-05-25,158,81,77,100,47,53,3
"383",2017-05-26,130,55,75,100,49,51,3
"384",2017-05-27,130,53,77,100,43,57,3
"385",2017-05-28,147,77,70,100,49,51,3
"386",2017-05-29,123,29,94,100,27,73,3
"387",2017-05-30,171,118,53,100,63,37,3
"388",2017-05-31,134,47,87,100,42,58,3
"389",2017-06-01,149,89,60,100,50,50,3
"390",2017-06-02,144,63,81,100,47,53,3
"391",2017-06-03,142,62,80,100,43,57,3
"392",2017-06-04,141,54,87,100,42,58,3
"393",2017-06-05,125,42,83,100,26,74,3
"394",2017-06-06,127,38,89,100,32,68,3
"395",2017-06-07,141,62,79,100,43,57,3
"396",2017-06-08,155,100,55,100,60,40,3
"397",2017-06-09,147,76,71,100,50,50,3
"398",2017-06-10,127,44,83,100,37,63,3
"399",2017-06-11,129,55,74,100,37,63,3
"400",2017-06-12,131,56,75,100,33,67,3
"401",2017-06-13,131,43,88,100,32,68,3
"402",2017-06-14,151,53,98,100,45,55,3
"403",2017-06-15,140,58,82,100,43,57,3
"404",2017-06-16,142,77,65,100,56,44,3
"405",2017-06-17,166,94,72,100,63,37,3
"406",2017-06-18,128,43,85,100,30,70,3
"407",2017-06-19,142,69,73,100,45,55,3
"408",2017-06-20,128,55,73,100,37,63,3
"409",2017-06-21,152,91,61,100,60,40,3
"410",2017-06-22,128,51,77,100,36,64,3
"411",2017-06-23,145,71,74,100,54,46,3
"412",2017-06-24,145,65,80,100,51,49,3
"413",2017-06-25,144,19,125,100,16,84,3
"414",2017-06-26,142,66,76,100,52,48,3
"415",2017-06-27,136,69,67,100,42,58,3
"416",2017-06-28,148,74,74,100,46,54,3
"417",2017-06-29,131,64,67,100,48,52,3
"418",2017-06-30,141,51,90,100,50,50,3
"419",2017-07-01,151,52,99,100,39,61,3
"420",2017-07-02,130,44,86,100,20,80,3
"421",2017-07-03,133,52,81,100,24,76,3
"422",2017-07-04,148,29,119,100,30,70,3
"423",2017-07-05,138,72,66,100,62,38,3
"424",2017-07-06,131,36,95,100,37,63,3
"425",2017-07-07,133,65,68,100,55,45,3
"426",2017-07-08,136,44,92,100,29,71,3
"427",2017-07-09,135,52,83,100,39,61,3
"428",2017-07-10,128,58,70,100,39,61,3
"429",2017-07-11,134,51,83,100,41,59,3
"430",2017-07-12,157,73,84,100,32,68,3
"431",2017-07-13,152,43,109,100,31,69,3
"432",2017-07-14,130,54,76,100,38,62,3
"433",2017-07-15,131,48,83,100,35,65,3
"434",2017-07-16,134,39,95,100,32,68,3
"435",2017-07-17,136,52,84,100,40,60,3
"436",2017-07-18,140,38,102,100,32,68,3
"437",2017-07-19,141,30,111,100,20,80,3
"438",2017-07-20,134,45,89,100,34,66,3
"439",2017-07-21,129,46,83,100,36,64,3
"440",2017-07-22,145,39,106,100,34,66,3
"441",2017-07-23,144,59,85,100,50,50,3
"442",2017-07-24,132,40,92,100,38,62,3
"443",2017-07-25,142,58,84,100,37,63,3
"444",2017-07-26,157,73,84,100,44,56,3
"445",2017-07-27,133,44,89,100,41,59,3
"446",2017-07-28,142,82,60,100,57,43,3
"447",2017-07-29,144,59,85,100,43,57,3
"448",2017-07-30,133,52,81,100,36,64,3
"449",2017-07-31,136,45,91,100,37,63,3
"450",2017-08-01,138,76,62,100,45,55,3
"451",2017-08-02,135,47,88,100,36,64,3
"452",2017-08-03,126,42,84,100,38,62,3
"453",2017-08-04,136,40,96,100,29,71,3
"454",2017-08-05,134,50,84,100,39,61,3
"455",2017-08-06,138,45,93,100,36,64,3
"456",2017-08-07,136,49,87,100,38,62,3
"457",2017-08-08,149,81,68,100,51,49,3
"458",2017-08-09,138,44,94,100,31,69,3
"459",2017-08-10,133,53,80,100,41,59,3
"460",2017-08-11,134,66,68,100,41,59,3
"461",2017-08-12,145,63,82,100,32,68,3
"462",2017-08-13,137,59,78,100,36,64,3
"463",2017-08-14,132,40,92,100,27,73,3
"464",2017-08-15,142,64,78,100,29,71,3
"465",2017-08-16,135,76,59,100,56,44,3
"466",2017-08-17,135,62,73,100,33,67,3
"467",2017-08-18,135,65,70,100,57,43,3
"468",2017-08-19,138,60,78,100,46,54,3
"469",2017-08-20,129,29,100,100,32,68,3
"470",2017-08-21,135,41,94,100,44,56,3
"471",2017-08-22,133,40,93,100,25,75,3
"472",2017-08-23,126,38,88,100,29,71,3
"473",2017-08-24,126,43,83,100,38,62,3
"474",2017-08-25,154,35,119,100,25,75,3
"475",2017-08-26,141,61,80,100,37,63,3
"476",2017-08-27,123,34,89,100,36,64,3
"477",2017-08-28,126,24,102,100,26,74,3
"478",2017-08-29,143,57,86,100,34,66,3
"479",2017-08-30,135,34,101,100,26,74,3
"480",2017-08-31,130,42,88,100,39,61,3
"481",2017-03-25,141,64,77,100,48,52,4
"482",2017-03-26,129,31,98,100,35,65,4
"483",2017-03-27,120,23,97,100,13,87,4
"484",2017-03-28,126,45,81,100,29,71,4
"485",2017-03-29,119,18,101,100,21,79,4
"486",2017-03-30,131,41,90,100,32,68,4
"487",2017-03-31,143,69,74,100,52,48,4
"488",2017-04-01,126,54,72,100,37,63,4
"489",2017-04-02,125,24,101,100,21,79,4
"490",2017-04-03,138,57,81,100,41,59,4
"491",2017-04-04,161,105,56,100,58,42,4
"492",2017-04-05,136,62,74,100,43,57,4
"493",2017-04-06,163,101,62,100,60,40,4
"494",2017-04-07,126,47,79,100,41,59,4
"495",2017-04-08,129,61,68,100,48,52,4
"496",2017-04-09,142,76,66,100,47,53,4
"497",2017-04-10,127,51,76,100,39,61,4
"498",2017-04-11,126,33,93,100,19,81,4
"499",2017-04-12,133,57,76,100,39,61,4
"500",2017-04-13,136,57,79,100,52,48,4
"501",2017-04-14,126,54,72,100,55,45,4
"502",2017-04-15,143,88,55,100,63,37,4
"503",2017-04-16,139,76,63,100,55,45,4
"504",2017-04-17,129,45,84,100,37,63,4
"505",2017-04-18,130,53,77,100,44,56,4
"506",2017-04-19,120,39,81,100,21,79,4
"507",2017-04-20,135,60,75,100,32,68,4
"508",2017-04-21,151,88,63,100,59,41,4
"509",2017-04-22,182,145,37,100,66,34,4
"510",2017-04-23,150,72,78,100,50,50,4
"511",2017-04-24,125,36,89,100,27,73,4
"512",2017-04-25,134,48,86,100,41,59,4
"513",2017-04-26,178,134,44,100,74,26,4
"514",2017-04-27,145,75,70,100,51,49,4
"515",2017-04-28,129,60,69,100,46,54,4
"516",2017-04-29,144,91,53,100,55,45,4
"517",2017-04-30,126,36,90,100,36,64,4
"518",2017-05-01,136,61,75,100,48,52,4
"519",2017-05-02,123,34,89,100,20,80,4
"520",2017-05-03,153,107,46,100,64,36,4
"521",2017-05-04,153,86,67,100,62,38,4
"522",2017-05-05,131,64,67,100,42,58,4
"523",2017-05-06,146,75,71,100,62,38,4
"524",2017-05-07,126,42,84,100,36,64,4
"525",2017-05-08,131,66,65,100,49,51,4
"526",2017-05-09,133,52,81,100,33,67,4
"527",2017-05-10,125,41,84,100,51,49,4
"528",2017-05-11,129,47,82,100,37,63,4
"529",2017-05-12,130,54,76,100,47,53,4
"530",2017-05-13,139,54,85,100,54,46,4
"531",2017-05-14,117,17,100,100,17,83,4
"532",2017-05-15,162,113,49,100,70,30,4
"533",2017-05-16,131,70,61,100,45,55,4
"534",2017-05-17,126,35,91,100,27,73,4
"535",2017-05-18,129,50,79,100,34,66,4
"536",2017-05-19,169,125,44,100,79,21,4
"537",2017-05-20,140,88,52,100,58,42,4
"538",2017-05-21,124,36,88,100,40,60,4
"539",2017-05-22,124,57,67,100,45,55,4
"540",2017-05-23,128,31,97,100,24,76,4
"541",2017-05-24,135,67,68,100,40,60,4
"542",2017-05-25,154,66,88,100,51,49,4
"543",2017-05-26,133,61,72,100,52,48,4
"544",2017-05-27,129,44,85,100,45,55,4
"545",2017-05-28,145,66,79,100,40,60,4
"546",2017-05-29,126,27,99,100,27,73,4
"547",2017-05-30,167,117,50,100,69,31,4
"548",2017-05-31,135,58,77,100,35,65,4
"549",2017-06-01,146,79,67,100,45,55,4
"550",2017-06-02,142,66,76,100,50,50,4
"551",2017-06-03,149,69,80,100,45,55,4
"552",2017-06-04,138,52,86,100,37,63,4
"553",2017-06-05,123,26,97,100,27,73,4
"554",2017-06-06,127,49,78,100,29,71,4
"555",2017-06-07,146,77,69,100,44,56,4
"556",2017-06-08,162,112,50,100,70,30,4
"557",2017-06-09,148,72,76,100,46,54,4
"558",2017-06-10,126,50,76,100,35,65,4
"559",2017-06-11,127,41,86,100,36,64,4
"560",2017-06-12,132,56,76,100,44,56,4
"561",2017-06-13,132,39,93,100,37,63,4
"562",2017-06-14,156,59,97,100,39,61,4
"563",2017-06-15,134,51,83,100,38,62,4
"564",2017-06-16,144,74,70,100,52,48,4
"565",2017-06-17,164,95,69,100,67,33,4
"566",2017-06-18,130,47,83,100,35,65,4
"567",2017-06-19,141,71,70,100,31,69,4
"568",2017-06-20,130,56,74,100,41,59,4
"569",2017-06-21,146,81,65,100,62,38,4
"570",2017-06-22,128,38,90,100,35,65,4
"571",2017-06-23,150,85,65,100,43,57,4
"572",2017-06-24,150,76,74,100,40,60,4
"573",2017-06-25,144,16,128,100,13,87,4
"574",2017-06-26,146,74,72,100,60,40,4
"575",2017-06-27,131,61,70,100,40,60,4
"576",2017-06-28,143,74,69,100,48,52,4
"577",2017-06-29,129,56,73,100,45,55,4
"578",2017-06-30,142,61,81,100,41,59,4
"579",2017-07-01,147,43,104,100,31,69,4
"580",2017-07-02,133,52,81,100,36,64,4
"581",2017-07-03,133,39,94,100,36,64,4
"582",2017-07-04,152,33,119,100,22,78,4
"583",2017-07-05,141,74,67,100,59,41,4
"584",2017-07-06,132,40,92,100,37,63,4
"585",2017-07-07,135,59,76,100,52,48,4
"586",2017-07-08,137,50,87,100,36,64,4
"587",2017-07-09,139,66,73,100,47,53,4
"588",2017-07-10,130,55,75,100,35,65,4
"589",2017-07-11,136,63,73,100,38,62,4
"590",2017-07-12,154,65,89,100,35,65,4
"591",2017-07-13,149,43,106,100,21,79,4
"592",2017-07-14,128,50,78,100,40,60,4
"593",2017-07-15,135,58,77,100,47,53,4
"594",2017-07-16,131,38,93,100,34,66,4
"595",2017-07-17,135,56,79,100,39,61,4
"596",2017-07-18,146,49,97,100,38,62,4
"597",2017-07-19,145,39,106,100,22,78,4
"598",2017-07-20,137,46,91,100,43,57,4
"599",2017-07-21,128,41,87,100,27,73,4
"600",2017-07-22,145,36,109,100,24,76,4
"601",2017-07-23,149,73,76,100,46,54,4
"602",2017-07-24,132,46,86,100,29,71,4
"603",2017-07-25,144,55,89,100,34,66,4
"604",2017-07-26,160,79,81,100,49,51,4
"605",2017-07-27,132,46,86,100,44,56,4
"606",2017-07-28,134,68,66,100,60,40,4
"607",2017-07-29,146,81,65,100,44,56,4
"608",2017-07-30,130,53,77,100,37,63,4
"609",2017-07-31,138,53,85,100,32,68,4
"610",2017-08-01,143,66,77,100,41,59,4
"611",2017-08-02,136,48,88,100,26,74,4
"612",2017-08-03,129,47,82,100,22,78,4
"613",2017-08-04,136,39,97,100,33,67,4
"614",2017-08-05,136,42,94,100,36,64,4
"615",2017-08-06,140,54,86,100,37,63,4
"616",2017-08-07,134,39,95,100,26,74,4
"617",2017-08-08,146,70,76,100,55,45,4
"618",2017-08-09,141,53,88,100,38,62,4
"619",2017-08-10,133,57,76,100,40,60,4
"620",2017-08-11,133,55,78,100,51,49,4
"621",2017-08-12,145,50,95,100,34,66,4
"622",2017-08-13,136,51,85,100,40,60,4
"623",2017-08-14,133,47,86,100,37,63,4
"624",2017-08-15,138,51,87,100,43,57,4
"625",2017-08-16,132,79,53,100,52,48,4
"626",2017-08-17,136,49,87,100,37,63,4
"627",2017-08-18,136,63,73,100,52,48,4
"628",2017-08-19,133,58,75,100,42,58,4
"629",2017-08-20,130,28,102,100,17,83,4
"630",2017-08-21,135,46,89,100,38,62,4
"631",2017-08-22,131,37,94,100,32,68,4
"632",2017-08-23,126,40,86,100,35,65,4
"633",2017-08-24,127,43,84,100,27,73,4
"634",2017-08-25,153,40,113,100,26,74,4
"635",2017-08-26,142,55,87,100,38,62,4
"636",2017-08-27,127,37,90,100,32,68,4
"637",2017-08-28,128,22,106,100,20,80,4
"638",2017-08-29,135,42,93,100,30,70,4
"639",2017-08-30,133,33,100,100,25,75,4
"640",2017-08-31,133,58,75,100,39,61,4
"641",2017-03-25,140,65,75,100,46,54,5
"642",2017-03-26,126,29,97,100,21,79,5
"643",2017-03-27,121,23,98,100,19,81,5
"644",2017-03-28,127,30,97,100,32,68,5
"645",2017-03-29,119,17,102,100,17,83,5
"646",2017-03-30,131,47,84,100,31,69,5
"647",2017-03-31,143,71,72,100,40,60,5
"648",2017-04-01,126,41,85,100,44,56,5
"649",2017-04-02,125,28,97,100,14,86,5
"650",2017-04-03,135,54,81,100,28,72,5
"651",2017-04-04,154,89,65,100,56,44,5
"652",2017-04-05,141,73,68,100,44,56,5
"653",2017-04-06,161,91,70,100,65,35,5
"654",2017-04-07,127,47,80,100,45,55,5
"655",2017-04-08,132,66,66,100,54,46,5
"656",2017-04-09,141,68,73,100,53,47,5
"657",2017-04-10,125,39,86,100,40,60,5
"658",2017-04-11,128,44,84,100,34,66,5
"659",2017-04-12,134,61,73,100,36,64,5
"660",2017-04-13,138,73,65,100,45,55,5
"661",2017-04-14,125,49,76,100,30,70,5
"662",2017-04-15,142,89,53,100,57,43,5
"663",2017-04-16,138,69,69,100,48,52,5
"664",2017-04-17,126,38,88,100,36,64,5
"665",2017-04-18,129,45,84,100,43,57,5
"666",2017-04-19,122,34,88,100,33,67,5
"667",2017-04-20,140,71,69,100,46,54,5
"668",2017-04-21,149,88,61,100,59,41,5
"669",2017-04-22,163,105,58,100,78,22,5
"670",2017-04-23,148,68,80,100,38,62,5
"671",2017-04-24,125,31,94,100,31,69,5
"672",2017-04-25,138,59,79,100,34,66,5
"673",2017-04-26,178,137,41,100,73,27,5
"674",2017-04-27,143,70,73,100,52,48,5
"675",2017-04-28,127,63,64,100,38,62,5
"676",2017-04-29,144,94,50,100,66,34,5
"677",2017-04-30,127,41,86,100,29,71,5
"678",2017-05-01,142,77,65,100,49,51,5
"679",2017-05-02,123,36,87,100,21,79,5
"680",2017-05-03,145,98,47,100,64,36,5
"681",2017-05-04,156,104,52,100,66,34,5
"682",2017-05-05,132,58,74,100,44,56,5
"683",2017-05-06,146,78,68,100,52,48,5
"684",2017-05-07,127,51,76,100,50,50,5
"685",2017-05-08,132,71,61,100,46,54,5
"686",2017-05-09,134,56,78,100,33,67,5
"687",2017-05-10,125,50,75,100,47,53,5
"688",2017-05-11,134,47,87,100,38,62,5
"689",2017-05-12,129,56,73,100,38,62,5
"690",2017-05-13,145,77,68,100,54,46,5
"691",2017-05-14,118,26,92,100,16,84,5
"692",2017-05-15,167,125,42,100,69,31,5
"693",2017-05-16,130,65,65,100,37,63,5
"694",2017-05-17,128,34,94,100,25,75,5
"695",2017-05-18,130,43,87,100,40,60,5
"696",2017-05-19,167,120,47,100,75,25,5
"697",2017-05-20,144,82,62,100,62,38,5
"698",2017-05-21,126,42,84,100,38,62,5
"699",2017-05-22,122,50,72,100,44,56,5
"700",2017-05-23,133,56,77,100,32,68,5
"701",2017-05-24,134,59,75,100,42,58,5
"702",2017-05-25,151,65,86,100,47,53,5
"703",2017-05-26,135,61,74,100,39,61,5
"704",2017-05-27,128,42,86,100,34,66,5
"705",2017-05-28,144,64,80,100,48,52,5
"706",2017-05-29,122,19,103,100,23,77,5
"707",2017-05-30,165,112,53,100,63,37,5
"708",2017-05-31,134,48,86,100,45,55,5
"709",2017-06-01,147,71,76,100,49,51,5
"710",2017-06-02,139,67,72,100,46,54,5
"711",2017-06-03,147,58,89,100,33,67,5
"712",2017-06-04,143,60,83,100,34,66,5
"713",2017-06-05,123,39,84,100,23,77,5
"714",2017-06-06,127,46,81,100,38,62,5
"715",2017-06-07,140,62,78,100,51,49,5
"716",2017-06-08,164,115,49,100,73,27,5
"717",2017-06-09,146,63,83,100,40,60,5
"718",2017-06-10,126,52,74,100,40,60,5
"719",2017-06-11,127,46,81,100,42,58,5
"720",2017-06-12,135,57,78,100,38,62,5
"721",2017-06-13,136,39,97,100,28,72,5
"722",2017-06-14,158,59,99,100,29,71,5
"723",2017-06-15,139,54,85,100,39,61,5
"724",2017-06-16,141,71,70,100,47,53,5
"725",2017-06-17,168,115,53,100,59,41,5
"726",2017-06-18,131,45,86,100,37,63,5
"727",2017-06-19,136,56,80,100,39,61,5
"728",2017-06-20,132,54,78,100,31,69,5
"729",2017-06-21,147,85,62,100,47,53,5
"730",2017-06-22,127,44,83,100,47,53,5
"731",2017-06-23,142,67,75,100,47,53,5
"732",2017-06-24,143,69,74,100,53,47,5
"733",2017-06-25,144,20,124,100,13,87,5
"734",2017-06-26,148,85,63,100,46,54,5
"735",2017-06-27,135,63,72,100,48,52,5
"736",2017-06-28,145,74,71,100,53,47,5
"737",2017-06-29,130,51,79,100,43,57,5
"738",2017-06-30,141,60,81,100,39,61,5
"739",2017-07-01,151,54,97,100,36,64,5
"740",2017-07-02,130,47,83,100,34,66,5
"741",2017-07-03,131,50,81,100,33,67,5
"742",2017-07-04,150,39,111,100,17,83,5
"743",2017-07-05,144,78,66,100,55,45,5
"744",2017-07-06,129,31,98,100,33,67,5
"745",2017-07-07,136,70,66,100,56,44,5
"746",2017-07-08,138,46,92,100,34,66,5
"747",2017-07-09,136,58,78,100,49,51,5
"748",2017-07-10,129,45,84,100,35,65,5
"749",2017-07-11,137,59,78,100,39,61,5
"750",2017-07-12,152,58,94,100,51,49,5
"751",2017-07-13,151,40,111,100,25,75,5
"752",2017-07-14,129,48,81,100,38,62,5
"753",2017-07-15,133,45,88,100,52,48,5
"754",2017-07-16,138,44,94,100,42,58,5
"755",2017-07-17,138,56,82,100,37,63,5
"756",2017-07-18,144,58,86,100,32,68,5
"757",2017-07-19,141,32,109,100,21,79,5
"758",2017-07-20,134,54,80,100,36,64,5
"759",2017-07-21,126,35,91,100,31,69,5
"760",2017-07-22,143,37,106,100,28,72,5
"761",2017-07-23,149,69,80,100,58,42,5
"762",2017-07-24,131,47,84,100,36,64,5
"763",2017-07-25,143,47,96,100,39,61,5
"764",2017-07-26,163,72,91,100,49,51,5
"765",2017-07-27,135,57,78,100,35,65,5
"766",2017-07-28,138,81,57,100,53,47,5
"767",2017-07-29,145,67,78,100,45,55,5
"768",2017-07-30,131,50,81,100,34,66,5
"769",2017-07-31,135,48,87,100,34,66,5
"770",2017-08-01,139,65,74,100,44,56,5
"771",2017-08-02,131,36,95,100,30,70,5
"772",2017-08-03,130,49,81,100,38,62,5
"773",2017-08-04,139,42,97,100,21,79,5
"774",2017-08-05,133,47,86,100,39,61,5
"775",2017-08-06,137,52,85,100,32,68,5
"776",2017-08-07,135,42,93,100,27,73,5
"777",2017-08-08,138,58,80,100,34,66,5
"778",2017-08-09,141,45,96,100,27,73,5
"779",2017-08-10,135,57,78,100,34,66,5
"780",2017-08-11,134,66,68,100,42,58,5
"781",2017-08-12,147,46,101,100,33,67,5
"782",2017-08-13,131,50,81,100,28,72,5
"783",2017-08-14,131,47,84,100,29,71,5
"784",2017-08-15,138,55,83,100,49,51,5
"785",2017-08-16,135,77,58,100,59,41,5
"786",2017-08-17,136,61,75,100,38,62,5
"787",2017-08-18,134,64,70,100,49,51,5
"788",2017-08-19,137,59,78,100,53,47,5
"789",2017-08-20,130,37,93,100,35,65,5
"790",2017-08-21,136,57,79,100,30,70,5
"791",2017-08-22,133,34,99,100,34,66,5
"792",2017-08-23,128,32,96,100,41,59,5
"793",2017-08-24,126,46,80,100,37,63,5
"794",2017-08-25,154,34,120,100,28,72,5
"795",2017-08-26,150,51,99,100,40,60,5
"796",2017-08-27,121,33,88,100,35,65,5
"797",2017-08-28,129,30,99,100,22,78,5
"798",2017-08-29,138,45,93,100,42,58,5
"799",2017-08-30,133,38,95,100,27,73,5
"800",2017-08-31,132,55,77,100,45,55,5
"801",2017-03-25,142,68,74,100,47,53,6
"802",2017-03-26,127,29,98,100,28,72,6
"803",2017-03-27,121,17,104,100,17,83,6
"804",2017-03-28,125,35,90,100,20,80,6
"805",2017-03-29,121,23,98,100,19,81,6
"806",2017-03-30,134,54,80,100,46,54,6
"807",2017-03-31,138,61,77,100,52,48,6
"808",2017-04-01,125,57,68,100,37,63,6
"809",2017-04-02,125,22,103,100,19,81,6
"810",2017-04-03,132,46,86,100,38,62,6
"811",2017-04-04,156,91,65,100,60,40,6
"812",2017-04-05,133,61,72,100,45,55,6
"813",2017-04-06,170,118,52,100,71,29,6
"814",2017-04-07,126,48,78,100,33,67,6
"815",2017-04-08,129,56,73,100,38,62,6
"816",2017-04-09,140,63,77,100,52,48,6
"817",2017-04-10,125,44,81,100,32,68,6
"818",2017-04-11,128,40,88,100,22,78,6
"819",2017-04-12,132,49,83,100,37,63,6
"820",2017-04-13,132,76,56,100,50,50,6
"821",2017-04-14,127,62,65,100,55,45,6
"822",2017-04-15,138,83,55,100,55,45,6
"823",2017-04-16,137,65,72,100,54,46,6
"824",2017-04-17,128,31,97,100,34,66,6
"825",2017-04-18,130,56,74,100,49,51,6
"826",2017-04-19,122,43,79,100,27,73,6
"827",2017-04-20,135,58,77,100,40,60,6
"828",2017-04-21,145,90,55,100,61,39,6
"829",2017-04-22,169,124,45,100,77,23,6
"830",2017-04-23,140,60,80,100,38,62,6
"831",2017-04-24,124,42,82,100,27,73,6
"832",2017-04-25,137,56,81,100,40,60,6
"833",2017-04-26,169,126,43,100,82,18,6
"834",2017-04-27,148,81,67,100,50,50,6
"835",2017-04-28,128,52,76,100,41,59,6
"836",2017-04-29,142,89,53,100,57,43,6
"837",2017-04-30,127,41,86,100,28,72,6
"838",2017-05-01,134,68,66,100,49,51,6
"839",2017-05-02,122,31,91,100,18,82,6
"840",2017-05-03,146,96,50,100,71,29,6
"841",2017-05-04,158,107,51,100,64,36,6
"842",2017-05-05,133,72,61,100,43,57,6
"843",2017-05-06,148,86,62,100,46,54,6
"844",2017-05-07,128,44,84,100,45,55,6
"845",2017-05-08,130,71,59,100,45,55,6
"846",2017-05-09,134,50,84,100,35,65,6
"847",2017-05-10,131,60,71,100,45,55,6
"848",2017-05-11,132,49,83,100,44,56,6
"849",2017-05-12,129,57,72,100,40,60,6
"850",2017-05-13,138,64,74,100,41,59,6
"851",2017-05-14,119,25,94,100,14,86,6
"852",2017-05-15,160,110,50,100,81,19,6
"853",2017-05-16,127,46,81,100,43,57,6
"854",2017-05-17,126,34,92,100,40,60,6
"855",2017-05-18,131,64,67,100,39,61,6
"856",2017-05-19,166,114,52,100,74,26,6
"857",2017-05-20,143,83,60,100,56,44,6
"858",2017-05-21,125,50,75,100,42,58,6
"859",2017-05-22,121,53,68,100,36,64,6
"860",2017-05-23,131,42,89,100,30,70,6
"861",2017-05-24,137,63,74,100,52,48,6
"862",2017-05-25,156,73,83,100,51,49,6
"863",2017-05-26,135,50,85,100,38,62,6
"864",2017-05-27,131,46,85,100,38,62,6
"865",2017-05-28,142,63,79,100,49,51,6
"866",2017-05-29,124,39,85,100,23,77,6
"867",2017-05-30,161,108,53,100,74,26,6
"868",2017-05-31,140,61,79,100,49,51,6
"869",2017-06-01,143,63,80,100,62,38,6
"870",2017-06-02,145,67,78,100,52,48,6
"871",2017-06-03,147,59,88,100,37,63,6
"872",2017-06-04,141,60,81,100,40,60,6
"873",2017-06-05,123,40,83,100,34,66,6
"874",2017-06-06,126,41,85,100,26,74,6
"875",2017-06-07,140,64,76,100,47,53,6
"876",2017-06-08,167,116,51,100,68,32,6
"877",2017-06-09,146,70,76,100,45,55,6
"878",2017-06-10,125,43,82,100,46,54,6
"879",2017-06-11,135,67,68,100,38,62,6
"880",2017-06-12,135,57,78,100,45,55,6
"881",2017-06-13,133,45,88,100,29,71,6
"882",2017-06-14,154,70,84,100,41,59,6
"883",2017-06-15,137,53,84,100,40,60,6
"884",2017-06-16,141,70,71,100,43,57,6
"885",2017-06-17,162,94,68,100,59,41,6
"886",2017-06-18,130,42,88,100,36,64,6
"887",2017-06-19,138,55,83,100,47,53,6
"888",2017-06-20,129,43,86,100,43,57,6
"889",2017-06-21,143,77,66,100,63,37,6
"890",2017-06-22,130,54,76,100,47,53,6
"891",2017-06-23,147,86,61,100,56,44,6
"892",2017-06-24,147,85,62,100,50,50,6
"893",2017-06-25,142,18,124,100,8,92,6
"894",2017-06-26,145,68,77,100,56,44,6
"895",2017-06-27,132,57,75,100,44,56,6
"896",2017-06-28,150,73,77,100,64,36,6
"897",2017-06-29,131,66,65,100,52,48,6
"898",2017-06-30,147,65,82,100,48,52,6
"899",2017-07-01,151,56,95,100,35,65,6
"900",2017-07-02,130,52,78,100,40,60,6
"901",2017-07-03,131,28,103,100,34,66,6
"902",2017-07-04,150,32,118,100,28,72,6
"903",2017-07-05,139,72,67,100,48,52,6
"904",2017-07-06,134,38,96,100,30,70,6
"905",2017-07-07,137,69,68,100,51,49,6
"906",2017-07-08,136,53,83,100,27,73,6
"907",2017-07-09,142,70,72,100,50,50,6
"908",2017-07-10,132,54,78,100,43,57,6
"909",2017-07-11,130,44,86,100,40,60,6
"910",2017-07-12,154,69,85,100,36,64,6
"911",2017-07-13,151,42,109,100,35,65,6
"912",2017-07-14,129,48,81,100,37,63,6
"913",2017-07-15,132,48,84,100,38,62,6
"914",2017-07-16,134,36,98,100,19,81,6
"915",2017-07-17,135,47,88,100,29,71,6
"916",2017-07-18,142,48,94,100,42,58,6
"917",2017-07-19,139,32,107,100,23,77,6
"918",2017-07-20,135,48,87,100,27,73,6
"919",2017-07-21,129,43,86,100,26,74,6
"920",2017-07-22,145,39,106,100,32,68,6
"921",2017-07-23,146,67,79,100,39,61,6
"922",2017-07-24,131,49,82,100,27,73,6
"923",2017-07-25,147,57,90,100,38,62,6
"924",2017-07-26,163,72,91,100,43,57,6
"925",2017-07-27,134,54,80,100,38,62,6
"926",2017-07-28,139,89,50,100,55,45,6
"927",2017-07-29,147,67,80,100,48,52,6
"928",2017-07-30,135,48,87,100,30,70,6
"929",2017-07-31,136,44,92,100,29,71,6
"930",2017-08-01,136,67,69,100,39,61,6
"931",2017-08-02,135,45,90,100,29,71,6
"932",2017-08-03,129,47,82,100,38,62,6
"933",2017-08-04,140,31,109,100,32,68,6
"934",2017-08-05,136,50,86,100,37,63,6
"935",2017-08-06,136,36,100,100,42,58,6
"936",2017-08-07,133,44,89,100,34,66,6
"937",2017-08-08,147,75,72,100,50,50,6
"938",2017-08-09,141,52,89,100,28,72,6
"939",2017-08-10,133,56,77,100,50,50,6
"940",2017-08-11,134,46,88,100,45,55,6
"941",2017-08-12,144,48,96,100,42,58,6
"942",2017-08-13,136,57,79,100,38,62,6
"943",2017-08-14,136,53,83,100,41,59,6
"944",2017-08-15,135,43,92,100,38,62,6
"945",2017-08-16,132,69,63,100,56,44,6
"946",2017-08-17,136,61,75,100,35,65,6
"947",2017-08-18,135,64,71,100,41,59,6
"948",2017-08-19,133,60,73,100,51,49,6
"949",2017-08-20,132,29,103,100,28,72,6
"950",2017-08-21,135,44,91,100,28,72,6
"951",2017-08-22,131,34,97,100,41,59,6
"952",2017-08-23,132,43,89,100,35,65,6
"953",2017-08-24,125,32,93,100,27,73,6
"954",2017-08-25,154,35,119,100,26,74,6
"955",2017-08-26,149,42,107,100,42,58,6
"956",2017-08-27,125,28,97,100,31,69,6
"957",2017-08-28,127,20,107,100,15,85,6
"958",2017-08-29,136,45,91,100,30,70,6
"959",2017-08-30,133,32,101,100,28,72,6
"960",2017-08-31,131,47,84,100,39,61,6
"961",2017-03-25,142,66,76,100,44,56,7
"962",2017-03-26,126,38,88,100,29,71,7
"963",2017-03-27,119,18,101,100,17,83,7
"964",2017-03-28,126,21,105,100,28,72,7
"965",2017-03-29,120,28,92,100,12,88,7
"966",2017-03-30,132,59,73,100,39,61,7
"967",2017-03-31,141,67,74,100,52,48,7
"968",2017-04-01,124,57,67,100,38,62,7
"969",2017-04-02,126,22,104,100,18,82,7
"970",2017-04-03,134,53,81,100,43,57,7
"971",2017-04-04,155,88,67,100,59,41,7
"972",2017-04-05,137,57,80,100,55,45,7
"973",2017-04-06,168,107,61,100,61,39,7
"974",2017-04-07,126,46,80,100,32,68,7
"975",2017-04-08,129,66,63,100,56,44,7
"976",2017-04-09,142,61,81,100,52,48,7
"977",2017-04-10,127,54,73,100,44,56,7
"978",2017-04-11,127,33,94,100,33,67,7
"979",2017-04-12,131,54,77,100,37,63,7
"980",2017-04-13,139,75,64,100,56,44,7
"981",2017-04-14,126,58,68,100,46,54,7
"982",2017-04-15,146,91,55,100,60,40,7
"983",2017-04-16,139,77,62,100,56,44,7
"984",2017-04-17,125,37,88,100,37,63,7
"985",2017-04-18,132,62,70,100,47,53,7
"986",2017-04-19,122,43,79,100,28,72,7
"987",2017-04-20,134,50,84,100,44,56,7
"988",2017-04-21,148,94,54,100,60,40,7
"989",2017-04-22,176,126,50,100,76,24,7
"990",2017-04-23,146,66,80,100,29,71,7
"991",2017-04-24,125,37,88,100,25,75,7
"992",2017-04-25,135,51,84,100,39,61,7
"993",2017-04-26,181,146,35,100,74,26,7
"994",2017-04-27,148,89,59,100,58,42,7
"995",2017-04-28,125,56,69,100,44,56,7
"996",2017-04-29,141,90,51,100,53,47,7
"997",2017-04-30,124,41,83,100,35,65,7
"998",2017-05-01,137,64,73,100,41,59,7
"999",2017-05-02,122,37,85,100,31,69,7
"1000",2017-05-03,141,89,52,100,63,37,7
"1001",2017-05-04,151,86,65,100,62,38,7
"1002",2017-05-05,130,60,70,100,43,57,7
"1003",2017-05-06,138,71,67,100,64,36,7
"1004",2017-05-07,127,53,74,100,39,61,7
"1005",2017-05-08,132,64,68,100,53,47,7
"1006",2017-05-09,128,40,88,100,41,59,7
"1007",2017-05-10,131,66,65,100,40,60,7
"1008",2017-05-11,131,44,87,100,33,67,7
"1009",2017-05-12,130,51,79,100,44,56,7
"1010",2017-05-13,136,52,84,100,42,58,7
"1011",2017-05-14,118,21,97,100,24,76,7
"1012",2017-05-15,171,135,36,100,72,28,7
"1013",2017-05-16,131,52,79,100,43,57,7
"1014",2017-05-17,127,28,99,100,30,70,7
"1015",2017-05-18,131,49,82,100,37,63,7
"1016",2017-05-19,171,128,43,100,78,22,7
"1017",2017-05-20,139,79,60,100,62,38,7
"1018",2017-05-21,123,39,84,100,39,61,7
"1019",2017-05-22,121,49,72,100,47,53,7
"1020",2017-05-23,128,34,94,100,39,61,7
"1021",2017-05-24,136,61,75,100,57,43,7
"1022",2017-05-25,149,55,94,100,48,52,7
"1023",2017-05-26,132,60,72,100,44,56,7
"1024",2017-05-27,132,43,89,100,41,59,7
"1025",2017-05-28,146,69,77,100,44,56,7
"1026",2017-05-29,121,27,94,100,21,79,7
"1027",2017-05-30,170,121,49,100,62,38,7
"1028",2017-05-31,142,52,90,100,31,69,7
"1029",2017-06-01,150,83,67,100,49,51,7
"1030",2017-06-02,145,78,67,100,53,47,7
"1031",2017-06-03,146,62,84,100,46,54,7
"1032",2017-06-04,139,50,89,100,37,63,7
"1033",2017-06-05,121,39,82,100,35,65,7
"1034",2017-06-06,127,42,85,100,36,64,7
"1035",2017-06-07,138,64,74,100,56,44,7
"1036",2017-06-08,166,124,42,100,70,30,7
"1037",2017-06-09,144,62,82,100,47,53,7
"1038",2017-06-10,125,53,72,100,31,69,7
"1039",2017-06-11,129,52,77,100,43,57,7
"1040",2017-06-12,131,54,77,100,48,52,7
"1041",2017-06-13,134,50,84,100,39,61,7
"1042",2017-06-14,157,66,91,100,38,62,7
"1043",2017-06-15,141,56,85,100,41,59,7
"1044",2017-06-16,143,77,66,100,40,60,7
"1045",2017-06-17,170,99,71,100,61,39,7
"1046",2017-06-18,132,44,88,100,37,63,7
"1047",2017-06-19,142,64,78,100,43,57,7
"1048",2017-06-20,131,44,87,100,39,61,7
"1049",2017-06-21,146,81,65,100,50,50,7
"1050",2017-06-22,131,50,81,100,26,74,7
"1051",2017-06-23,151,94,57,100,55,45,7
"1052",2017-06-24,151,76,75,100,48,52,7
"1053",2017-06-25,145,22,123,100,13,87,7
"1054",2017-06-26,146,78,68,100,57,43,7
"1055",2017-06-27,135,48,87,100,52,48,7
"1056",2017-06-28,148,75,73,100,50,50,7
"1057",2017-06-29,131,52,79,100,44,56,7
"1058",2017-06-30,142,58,84,100,47,53,7
"1059",2017-07-01,148,52,96,100,34,66,7
"1060",2017-07-02,130,45,85,100,32,68,7
"1061",2017-07-03,130,31,99,100,37,63,7
"1062",2017-07-04,147,36,111,100,20,80,7
"1063",2017-07-05,144,81,63,100,56,44,7
"1064",2017-07-06,131,41,90,100,31,69,7
"1065",2017-07-07,135,65,70,100,45,55,7
"1066",2017-07-08,135,37,98,100,31,69,7
"1067",2017-07-09,137,64,73,100,41,59,7
"1068",2017-07-10,131,49,82,100,41,59,7
"1069",2017-07-11,134,49,85,100,40,60,7
"1070",2017-07-12,150,54,96,100,38,62,7
"1071",2017-07-13,150,49,101,100,33,67,7
"1072",2017-07-14,128,52,76,100,28,72,7
"1073",2017-07-15,134,47,87,100,39,61,7
"1074",2017-07-16,132,43,89,100,35,65,7
"1075",2017-07-17,139,53,86,100,52,48,7
"1076",2017-07-18,141,55,86,100,36,64,7
"1077",2017-07-19,141,23,118,100,22,78,7
"1078",2017-07-20,137,45,92,100,25,75,7
"1079",2017-07-21,128,43,85,100,25,75,7
"1080",2017-07-22,146,46,100,100,27,73,7
"1081",2017-07-23,149,71,78,100,47,53,7
"1082",2017-07-24,130,39,91,100,36,64,7
"1083",2017-07-25,139,51,88,100,37,63,7
"1084",2017-07-26,160,81,79,100,47,53,7
"1085",2017-07-27,136,53,83,100,34,66,7
"1086",2017-07-28,139,79,60,100,67,33,7
"1087",2017-07-29,148,64,84,100,54,46,7
"1088",2017-07-30,132,51,81,100,37,63,7
"1089",2017-07-31,138,41,97,100,35,65,7
"1090",2017-08-01,140,54,86,100,43,57,7
"1091",2017-08-02,131,45,86,100,28,72,7
"1092",2017-08-03,127,42,85,100,31,69,7
"1093",2017-08-04,140,46,94,100,26,74,7
"1094",2017-08-05,134,50,84,100,29,71,7
"1095",2017-08-06,138,48,90,100,41,59,7
"1096",2017-08-07,134,36,98,100,40,60,7
"1097",2017-08-08,150,64,86,100,50,50,7
"1098",2017-08-09,140,45,95,100,34,66,7
"1099",2017-08-10,134,49,85,100,48,52,7
"1100",2017-08-11,134,54,80,100,47,53,7
"1101",2017-08-12,146,49,97,100,29,71,7
"1102",2017-08-13,134,38,96,100,44,56,7
"1103",2017-08-14,133,43,90,100,34,66,7
"1104",2017-08-15,139,60,79,100,35,65,7
"1105",2017-08-16,134,72,62,100,59,41,7
"1106",2017-08-17,138,60,78,100,46,54,7
"1107",2017-08-18,133,62,71,100,43,57,7
"1108",2017-08-19,138,61,77,100,52,48,7
"1109",2017-08-20,127,34,93,100,27,73,7
"1110",2017-08-21,137,55,82,100,34,66,7
"1111",2017-08-22,130,45,85,100,34,66,7
"1112",2017-08-23,128,41,87,100,32,68,7
"1113",2017-08-24,125,44,81,100,40,60,7
"1114",2017-08-25,155,41,114,100,25,75,7
"1115",2017-08-26,145,59,86,100,34,66,7
"1116",2017-08-27,123,30,93,100,35,65,7
"1117",2017-08-28,129,32,97,100,19,81,7
"1118",2017-08-29,139,43,96,100,34,66,7
"1119",2017-08-30,133,42,91,100,32,68,7
"1120",2017-08-31,132,52,80,100,45,55,7
"1121",2017-03-25,143,68,75,100,44,56,8
"1122",2017-03-26,128,23,105,100,29,71,8
"1123",2017-03-27,120,22,98,100,15,85,8
"1124",2017-03-28,125,31,94,100,25,75,8
"1125",2017-03-29,120,17,103,100,9,91,8
"1126",2017-03-30,130,41,89,100,41,59,8
"1127",2017-03-31,142,66,76,100,47,53,8
"1128",2017-04-01,125,56,69,100,36,64,8
"1129",2017-04-02,126,21,105,100,17,83,8
"1130",2017-04-03,135,57,78,100,36,64,8
"1131",2017-04-04,151,93,58,100,62,38,8
"1132",2017-04-05,135,57,78,100,39,61,8
"1133",2017-04-06,163,106,57,100,51,49,8
"1134",2017-04-07,127,49,78,100,41,59,8
"1135",2017-04-08,130,63,67,100,47,53,8
"1136",2017-04-09,141,68,73,100,63,37,8
"1137",2017-04-10,125,55,70,100,37,63,8
"1138",2017-04-11,127,33,94,100,28,72,8
"1139",2017-04-12,130,50,80,100,47,53,8
"1140",2017-04-13,135,58,77,100,59,41,8
"1141",2017-04-14,127,41,86,100,45,55,8
"1142",2017-04-15,146,96,50,100,61,39,8
"1143",2017-04-16,139,73,66,100,49,51,8
"1144",2017-04-17,127,44,83,100,31,69,8
"1145",2017-04-18,132,69,63,100,52,48,8
"1146",2017-04-19,121,26,95,100,25,75,8
"1147",2017-04-20,130,50,80,100,42,58,8
"1148",2017-04-21,149,90,59,100,60,40,8
"1149",2017-04-22,176,139,37,100,75,25,8
"1150",2017-04-23,142,60,82,100,44,56,8
"1151",2017-04-24,125,33,92,100,30,70,8
"1152",2017-04-25,133,43,90,100,37,63,8
"1153",2017-04-26,172,124,48,100,75,25,8
"1154",2017-04-27,144,76,68,100,57,43,8
"1155",2017-04-28,127,54,73,100,43,57,8
"1156",2017-04-29,143,86,57,100,50,50,8
"1157",2017-04-30,127,48,79,100,32,68,8
"1158",2017-05-01,135,63,72,100,53,47,8
"1159",2017-05-02,123,32,91,100,19,81,8
"1160",2017-05-03,152,106,46,100,64,36,8
"1161",2017-05-04,155,105,50,100,68,32,8
"1162",2017-05-05,134,69,65,100,43,57,8
"1163",2017-05-06,149,83,66,100,55,45,8
"1164",2017-05-07,128,60,68,100,39,61,8
"1165",2017-05-08,134,69,65,100,50,50,8
"1166",2017-05-09,133,45,88,100,34,66,8
"1167",2017-05-10,124,59,65,100,45,55,8
"1168",2017-05-11,134,56,78,100,38,62,8
"1169",2017-05-12,127,50,77,100,34,66,8
"1170",2017-05-13,142,63,79,100,40,60,8
"1171",2017-05-14,118,16,102,100,18,82,8
"1172",2017-05-15,178,139,39,100,73,27,8
"1173",2017-05-16,128,63,65,100,45,55,8
"1174",2017-05-17,129,42,87,100,31,69,8
"1175",2017-05-18,135,53,82,100,40,60,8
"1176",2017-05-19,171,126,45,100,74,26,8
"1177",2017-05-20,139,77,62,100,65,35,8
"1178",2017-05-21,124,38,86,100,30,70,8
"1179",2017-05-22,123,48,75,100,46,54,8
"1180",2017-05-23,128,45,83,100,32,68,8
"1181",2017-05-24,136,74,62,100,48,52,8
"1182",2017-05-25,151,60,91,100,40,60,8
"1183",2017-05-26,135,63,72,100,42,58,8
"1184",2017-05-27,129,51,78,100,40,60,8
"1185",2017-05-28,142,63,79,100,40,60,8
"1186",2017-05-29,126,37,89,100,28,72,8
"1187",2017-05-30,165,110,55,100,67,33,8
"1188",2017-05-31,135,47,88,100,46,54,8
"1189",2017-06-01,146,64,82,100,60,40,8
"1190",2017-06-02,143,67,76,100,49,51,8
"1191",2017-06-03,148,53,95,100,38,62,8
"1192",2017-06-04,141,52,89,100,39,61,8
"1193",2017-06-05,123,42,81,100,30,70,8
"1194",2017-06-06,124,36,88,100,28,72,8
"1195",2017-06-07,143,71,72,100,47,53,8
"1196",2017-06-08,160,125,35,100,70,30,8
"1197",2017-06-09,147,74,73,100,38,62,8
"1198",2017-06-10,125,46,79,100,41,59,8
"1199",2017-06-11,129,49,80,100,36,64,8
"1200",2017-06-12,133,48,85,100,42,58,8
"1201",2017-06-13,134,43,91,100,34,66,8
"1202",2017-06-14,150,51,99,100,37,63,8
"1203",2017-06-15,137,55,82,100,36,64,8
"1204",2017-06-16,140,70,70,100,53,47,8
"1205",2017-06-17,156,78,78,100,59,41,8
"1206",2017-06-18,134,49,85,100,29,71,8
"1207",2017-06-19,137,55,82,100,42,58,8
"1208",2017-06-20,129,49,80,100,36,64,8
"1209",2017-06-21,141,69,72,100,61,39,8
"1210",2017-06-22,129,58,71,100,46,54,8
"1211",2017-06-23,147,78,69,100,56,44,8
"1212",2017-06-24,149,80,69,100,47,53,8
"1213",2017-06-25,143,18,125,100,11,89,8
"1214",2017-06-26,144,69,75,100,53,47,8
"1215",2017-06-27,135,61,74,100,54,46,8
"1216",2017-06-28,150,84,66,100,52,48,8
"1217",2017-06-29,130,54,76,100,40,60,8
"1218",2017-06-30,140,65,75,100,45,55,8
"1219",2017-07-01,150,54,96,100,24,76,8
"1220",2017-07-02,130,50,80,100,32,68,8
"1221",2017-07-03,131,42,89,100,36,64,8
"1222",2017-07-04,148,31,117,100,20,80,8
"1223",2017-07-05,137,62,75,100,46,54,8
"1224",2017-07-06,131,36,95,100,28,72,8
"1225",2017-07-07,136,69,67,100,51,49,8
"1226",2017-07-08,135,50,85,100,35,65,8
"1227",2017-07-09,142,71,71,100,41,59,8
"1228",2017-07-10,129,50,79,100,35,65,8
"1229",2017-07-11,136,53,83,100,32,68,8
"1230",2017-07-12,154,58,96,100,37,63,8
"1231",2017-07-13,150,46,104,100,35,65,8
"1232",2017-07-14,130,51,79,100,39,61,8
"1233",2017-07-15,133,51,82,100,39,61,8
"1234",2017-07-16,133,37,96,100,36,64,8
"1235",2017-07-17,137,57,80,100,32,68,8
"1236",2017-07-18,139,43,96,100,27,73,8
"1237",2017-07-19,143,36,107,100,22,78,8
"1238",2017-07-20,134,35,99,100,34,66,8
"1239",2017-07-21,129,47,82,100,24,76,8
"1240",2017-07-22,147,41,106,100,36,64,8
"1241",2017-07-23,148,76,72,100,37,63,8
"1242",2017-07-24,131,36,95,100,35,65,8
"1243",2017-07-25,144,43,101,100,32,68,8
"1244",2017-07-26,158,79,79,100,52,48,8
"1245",2017-07-27,136,50,86,100,30,70,8
"1246",2017-07-28,137,83,54,100,52,48,8
"1247",2017-07-29,146,57,89,100,55,45,8
"1248",2017-07-30,132,42,90,100,32,68,8
"1249",2017-07-31,141,48,93,100,31,69,8
"1250",2017-08-01,137,57,80,100,42,58,8
"1251",2017-08-02,132,39,93,100,36,64,8
"1252",2017-08-03,131,50,81,100,30,70,8
"1253",2017-08-04,137,42,95,100,28,72,8
"1254",2017-08-05,139,61,78,100,26,74,8
"1255",2017-08-06,136,42,94,100,34,66,8
"1256",2017-08-07,134,39,95,100,34,66,8
"1257",2017-08-08,145,66,79,100,52,48,8
"1258",2017-08-09,141,53,88,100,37,63,8
"1259",2017-08-10,134,48,86,100,49,51,8
"1260",2017-08-11,134,48,86,100,42,58,8
"1261",2017-08-12,146,44,102,100,32,68,8
"1262",2017-08-13,134,49,85,100,41,59,8
"1263",2017-08-14,133,54,79,100,36,64,8
"1264",2017-08-15,137,55,82,100,42,58,8
"1265",2017-08-16,134,74,60,100,54,46,8
"1266",2017-08-17,136,57,79,100,46,54,8
"1267",2017-08-18,135,65,70,100,48,52,8
"1268",2017-08-19,134,60,74,100,47,53,8
"1269",2017-08-20,129,27,102,100,21,79,8
"1270",2017-08-21,136,40,96,100,40,60,8
"1271",2017-08-22,129,35,94,100,31,69,8
"1272",2017-08-23,128,45,83,100,30,70,8
"1273",2017-08-24,125,34,91,100,27,73,8
"1274",2017-08-25,152,37,115,100,29,71,8
"1275",2017-08-26,144,55,89,100,38,62,8
"1276",2017-08-27,126,34,92,100,33,67,8
"1277",2017-08-28,130,34,96,100,20,80,8
"1278",2017-08-29,137,38,99,100,28,72,8
"1279",2017-08-30,134,31,103,100,33,67,8
"1280",2017-08-31,133,62,71,100,46,54,8
"1281",2017-03-25,139,69,70,100,48,52,9
"1282",2017-03-26,127,33,94,100,29,71,9
"1283",2017-03-27,122,21,101,100,13,87,9
"1284",2017-03-28,125,31,94,100,26,74,9
"1285",2017-03-29,119,26,93,100,18,82,9
"1286",2017-03-30,135,57,78,100,51,49,9
"1287",2017-03-31,134,57,77,100,45,55,9
"1288",2017-04-01,126,42,84,100,43,57,9
"1289",2017-04-02,126,21,105,100,24,76,9
"1290",2017-04-03,133,48,85,100,45,55,9
"1291",2017-04-04,156,100,56,100,67,33,9
"1292",2017-04-05,134,64,70,100,58,42,9
"1293",2017-04-06,162,93,69,100,63,37,9
"1294",2017-04-07,128,53,75,100,32,68,9
"1295",2017-04-08,131,63,68,100,46,54,9
"1296",2017-04-09,140,63,77,100,46,54,9
"1297",2017-04-10,125,48,77,100,41,59,9
"1298",2017-04-11,127,32,95,100,37,63,9
"1299",2017-04-12,134,51,83,100,43,57,9
"1300",2017-04-13,137,72,65,100,55,45,9
"1301",2017-04-14,127,55,72,100,39,61,9
"1302",2017-04-15,144,87,57,100,65,35,9
"1303",2017-04-16,136,67,69,100,47,53,9
"1304",2017-04-17,129,52,77,100,38,62,9
"1305",2017-04-18,133,60,73,100,48,52,9
"1306",2017-04-19,120,25,95,100,19,81,9
"1307",2017-04-20,137,66,71,100,50,50,9
"1308",2017-04-21,149,93,56,100,62,38,9
"1309",2017-04-22,175,130,45,100,78,22,9
"1310",2017-04-23,144,63,81,100,42,58,9
"1311",2017-04-24,125,46,79,100,25,75,9
"1312",2017-04-25,135,38,97,100,41,59,9
"1313",2017-04-26,174,129,45,100,78,22,9
"1314",2017-04-27,141,74,67,100,52,48,9
"1315",2017-04-28,127,54,73,100,35,65,9
"1316",2017-04-29,135,72,63,100,60,40,9
"1317",2017-04-30,125,51,74,100,35,65,9
"1318",2017-05-01,138,72,66,100,56,44,9
"1319",2017-05-02,123,26,97,100,21,79,9
"1320",2017-05-03,150,100,50,100,71,29,9
"1321",2017-05-04,162,109,53,100,52,48,9
"1322",2017-05-05,130,51,79,100,52,48,9
"1323",2017-05-06,144,78,66,100,58,42,9
"1324",2017-05-07,127,58,69,100,35,65,9
"1325",2017-05-08,132,69,63,100,50,50,9
"1326",2017-05-09,134,46,88,100,37,63,9
"1327",2017-05-10,125,53,72,100,41,59,9
"1328",2017-05-11,137,57,80,100,39,61,9
"1329",2017-05-12,130,63,67,100,47,53,9
"1330",2017-05-13,140,71,69,100,42,58,9
"1331",2017-05-14,117,16,101,100,13,87,9
"1332",2017-05-15,165,115,50,100,74,26,9
"1333",2017-05-16,131,68,63,100,42,58,9
"1334",2017-05-17,129,39,90,100,23,77,9
"1335",2017-05-18,130,49,81,100,26,74,9
"1336",2017-05-19,166,118,48,100,70,30,9
"1337",2017-05-20,143,82,61,100,57,43,9
"1338",2017-05-21,126,46,80,100,39,61,9
"1339",2017-05-22,121,45,76,100,42,58,9
"1340",2017-05-23,129,42,87,100,36,64,9
"1341",2017-05-24,134,69,65,100,50,50,9
"1342",2017-05-25,153,62,91,100,42,58,9
"1343",2017-05-26,137,71,66,100,50,50,9
"1344",2017-05-27,130,56,74,100,36,64,9
"1345",2017-05-28,144,67,77,100,45,55,9
"1346",2017-05-29,124,27,97,100,27,73,9
"1347",2017-05-30,161,103,58,100,73,27,9
"1348",2017-05-31,139,44,95,100,42,58,9
"1349",2017-06-01,143,74,69,100,54,46,9
"1350",2017-06-02,140,64,76,100,53,47,9
"1351",2017-06-03,146,61,85,100,48,52,9
"1352",2017-06-04,140,57,83,100,42,58,9
"1353",2017-06-05,123,49,74,100,35,65,9
"1354",2017-06-06,127,37,90,100,36,64,9
"1355",2017-06-07,137,57,80,100,42,58,9
"1356",2017-06-08,160,102,58,100,68,32,9
"1357",2017-06-09,144,62,82,100,56,44,9
"1358",2017-06-10,127,49,78,100,37,63,9
"1359",2017-06-11,133,50,83,100,50,50,9
"1360",2017-06-12,134,57,77,100,42,58,9
"1361",2017-06-13,132,44,88,100,34,66,9
"1362",2017-06-14,157,69,88,100,46,54,9
"1363",2017-06-15,135,51,84,100,43,57,9
"1364",2017-06-16,134,50,84,100,46,54,9
"1365",2017-06-17,170,112,58,100,52,48,9
"1366",2017-06-18,132,49,83,100,39,61,9
"1367",2017-06-19,142,66,76,100,42,58,9
"1368",2017-06-20,125,52,73,100,44,56,9
"1369",2017-06-21,145,73,72,100,55,45,9
"1370",2017-06-22,129,44,85,100,37,63,9
"1371",2017-06-23,145,81,64,100,54,46,9
"1372",2017-06-24,152,84,68,100,54,46,9
"1373",2017-06-25,145,18,127,100,13,87,9
"1374",2017-06-26,146,73,73,100,59,41,9
"1375",2017-06-27,133,59,74,100,49,51,9
"1376",2017-06-28,149,82,67,100,54,46,9
"1377",2017-06-29,131,72,59,100,56,44,9
"1378",2017-06-30,141,60,81,100,54,46,9
"1379",2017-07-01,151,50,101,100,30,70,9
"1380",2017-07-02,132,47,85,100,30,70,9
"1381",2017-07-03,132,37,95,100,32,68,9
"1382",2017-07-04,150,31,119,100,19,81,9
"1383",2017-07-05,143,85,58,100,54,46,9
"1384",2017-07-06,131,36,95,100,37,63,9
"1385",2017-07-07,137,67,70,100,50,50,9
"1386",2017-07-08,140,44,96,100,24,76,9
"1387",2017-07-09,140,72,68,100,39,61,9
"1388",2017-07-10,130,49,81,100,38,62,9
"1389",2017-07-11,135,48,87,100,37,63,9
"1390",2017-07-12,151,54,97,100,41,59,9
"1391",2017-07-13,150,46,104,100,26,74,9
"1392",2017-07-14,132,57,75,100,38,62,9
"1393",2017-07-15,136,46,90,100,42,58,9
"1394",2017-07-16,135,35,100,100,24,76,9
"1395",2017-07-17,137,44,93,100,46,54,9
"1396",2017-07-18,144,48,96,100,32,68,9
"1397",2017-07-19,140,36,104,100,31,69,9
"1398",2017-07-20,137,51,86,100,26,74,9
"1399",2017-07-21,126,45,81,100,29,71,9
"1400",2017-07-22,147,46,101,100,28,72,9
"1401",2017-07-23,148,80,68,100,51,49,9
"1402",2017-07-24,131,39,92,100,34,66,9
"1403",2017-07-25,144,46,98,100,47,53,9
"1404",2017-07-26,167,82,85,100,43,57,9
"1405",2017-07-27,134,48,86,100,33,67,9
"1406",2017-07-28,137,65,72,100,62,38,9
"1407",2017-07-29,143,72,71,100,42,58,9
"1408",2017-07-30,130,51,79,100,32,68,9
"1409",2017-07-31,136,42,94,100,33,67,9
"1410",2017-08-01,137,76,61,100,52,48,9
"1411",2017-08-02,134,39,95,100,39,61,9
"1412",2017-08-03,129,52,77,100,42,58,9
"1413",2017-08-04,138,39,99,100,31,69,9
"1414",2017-08-05,135,46,89,100,28,72,9
"1415",2017-08-06,136,47,89,100,34,66,9
"1416",2017-08-07,133,37,96,100,28,72,9
"1417",2017-08-08,146,68,78,100,42,58,9
"1418",2017-08-09,141,50,91,100,35,65,9
"1419",2017-08-10,135,46,89,100,40,60,9
"1420",2017-08-11,136,52,84,100,40,60,9
"1421",2017-08-12,144,51,93,100,34,66,9
"1422",2017-08-13,134,62,72,100,39,61,9
"1423",2017-08-14,135,52,83,100,25,75,9
"1424",2017-08-15,142,60,82,100,38,62,9
"1425",2017-08-16,133,72,61,100,52,48,9
"1426",2017-08-17,136,53,83,100,36,64,9
"1427",2017-08-18,134,49,85,100,49,51,9
"1428",2017-08-19,136,60,76,100,39,61,9
"1429",2017-08-20,127,25,102,100,22,78,9
"1430",2017-08-21,137,46,91,100,30,70,9
"1431",2017-08-22,133,42,91,100,28,72,9
"1432",2017-08-23,128,38,90,100,29,71,9
"1433",2017-08-24,127,44,83,100,33,67,9
"1434",2017-08-25,151,37,114,100,17,83,9
"1435",2017-08-26,147,66,81,100,38,62,9
"1436",2017-08-27,127,31,96,100,26,74,9
"1437",2017-08-28,130,20,110,100,21,79,9
"1438",2017-08-29,138,42,96,100,42,58,9
"1439",2017-08-30,136,34,102,100,29,71,9
"1440",2017-08-31,131,54,77,100,32,68,9
"1441",2017-03-25,141,66,75,100,42,58,10
"1442",2017-03-26,129,35,94,100,32,68,10
"1443",2017-03-27,119,27,92,100,17,83,10
"1444",2017-03-28,125,36,89,100,19,81,10
"1445",2017-03-29,118,19,99,100,15,85,10
"1446",2017-03-30,132,53,79,100,42,58,10
"1447",2017-03-31,145,80,65,100,50,50,10
"1448",2017-04-01,125,47,78,100,37,63,10
"1449",2017-04-02,126,21,105,100,20,80,10
"1450",2017-04-03,130,50,80,100,41,59,10
"1451",2017-04-04,154,86,68,100,54,46,10
"1452",2017-04-05,139,67,72,100,51,49,10
"1453",2017-04-06,165,106,59,100,66,34,10
"1454",2017-04-07,127,48,79,100,42,58,10
"1455",2017-04-08,130,61,69,100,48,52,10
"1456",2017-04-09,139,73,66,100,59,41,10
"1457",2017-04-10,126,47,79,100,33,67,10
"1458",2017-04-11,129,50,79,100,29,71,10
"1459",2017-04-12,133,42,91,100,41,59,10
"1460",2017-04-13,135,69,66,100,53,47,10
"1461",2017-04-14,127,55,72,100,45,55,10
"1462",2017-04-15,141,79,62,100,57,43,10
"1463",2017-04-16,140,70,70,100,55,45,10
"1464",2017-04-17,128,43,85,100,31,69,10
"1465",2017-04-18,129,50,79,100,47,53,10
"1466",2017-04-19,121,33,88,100,30,70,10
"1467",2017-04-20,136,54,82,100,42,58,10
"1468",2017-04-21,147,86,61,100,58,42,10
"1469",2017-04-22,171,121,50,100,74,26,10
"1470",2017-04-23,147,73,74,100,40,60,10
"1471",2017-04-24,125,29,96,100,22,78,10
"1472",2017-04-25,134,47,87,100,36,64,10
"1473",2017-04-26,179,140,39,100,74,26,10
"1474",2017-04-27,145,76,69,100,51,49,10
"1475",2017-04-28,129,57,72,100,41,59,10
"1476",2017-04-29,141,88,53,100,53,47,10
"1477",2017-04-30,126,33,93,100,30,70,10
"1478",2017-05-01,134,60,74,100,44,56,10
"1479",2017-05-02,124,31,93,100,22,78,10
"1480",2017-05-03,145,93,52,100,65,35,10
"1481",2017-05-04,154,94,60,100,56,44,10
"1482",2017-05-05,134,65,69,100,52,48,10
"1483",2017-05-06,141,70,71,100,45,55,10
"1484",2017-05-07,127,45,82,100,41,59,10
"1485",2017-05-08,131,73,58,100,50,50,10
"1486",2017-05-09,135,53,82,100,30,70,10
"1487",2017-05-10,129,62,67,100,43,57,10
"1488",2017-05-11,130,54,76,100,41,59,10
"1489",2017-05-12,130,52,78,100,43,57,10
"1490",2017-05-13,138,67,71,100,57,43,10
"1491",2017-05-14,118,27,91,100,21,79,10
"1492",2017-05-15,169,117,52,100,75,25,10
"1493",2017-05-16,130,57,73,100,44,56,10
"1494",2017-05-17,123,27,96,100,32,68,10
"1495",2017-05-18,137,59,78,100,41,59,10
"1496",2017-05-19,174,132,42,100,73,27,10
"1497",2017-05-20,140,70,70,100,61,39,10
"1498",2017-05-21,123,32,91,100,33,67,10
"1499",2017-05-22,121,47,74,100,43,57,10
"1500",2017-05-23,132,41,91,100,22,78,10
"1501",2017-05-24,137,61,76,100,46,54,10
"1502",2017-05-25,154,70,84,100,47,53,10
"1503",2017-05-26,135,61,74,100,48,52,10
"1504",2017-05-27,130,47,83,100,39,61,10
"1505",2017-05-28,146,62,84,100,42,58,10
"1506",2017-05-29,125,34,91,100,17,83,10
"1507",2017-05-30,163,110,53,100,69,31,10
"1508",2017-05-31,136,55,81,100,36,64,10
"1509",2017-06-01,148,82,66,100,53,47,10
"1510",2017-06-02,142,69,73,100,41,59,10
"1511",2017-06-03,150,61,89,100,33,67,10
"1512",2017-06-04,137,56,81,100,35,65,10
"1513",2017-06-05,124,32,92,100,22,78,10
"1514",2017-06-06,125,38,87,100,34,66,10
"1515",2017-06-07,143,76,67,100,50,50,10
"1516",2017-06-08,165,122,43,100,69,31,10
"1517",2017-06-09,149,68,81,100,58,42,10
"1518",2017-06-10,125,51,74,100,32,68,10
"1519",2017-06-11,132,57,75,100,44,56,10
"1520",2017-06-12,134,61,73,100,36,64,10
"1521",2017-06-13,132,52,80,100,39,61,10
"1522",2017-06-14,157,70,87,100,39,61,10
"1523",2017-06-15,142,72,70,100,41,59,10
"1524",2017-06-16,145,72,73,100,42,58,10
"1525",2017-06-17,159,86,73,100,60,40,10
"1526",2017-06-18,131,45,86,100,42,58,10
"1527",2017-06-19,135,47,88,100,39,61,10
"1528",2017-06-20,131,57,74,100,40,60,10
"1529",2017-06-21,143,79,64,100,54,46,10
"1530",2017-06-22,127,44,83,100,40,60,10
"1531",2017-06-23,148,83,65,100,51,49,10
"1532",2017-06-24,146,74,72,100,47,53,10
"1533",2017-06-25,147,23,124,100,9,91,10
"1534",2017-06-26,144,67,77,100,37,63,10
"1535",2017-06-27,132,59,73,100,52,48,10
"1536",2017-06-28,143,74,69,100,50,50,10
"1537",2017-06-29,129,62,67,100,41,59,10
"1538",2017-06-30,145,66,79,100,45,55,10
"1539",2017-07-01,147,47,100,100,25,75,10
"1540",2017-07-02,133,51,82,100,39,61,10
"1541",2017-07-03,133,44,89,100,28,72,10
"1542",2017-07-04,149,38,111,100,27,73,10
"1543",2017-07-05,138,72,66,100,54,46,10
"1544",2017-07-06,130,44,86,100,32,68,10
"1545",2017-07-07,136,68,68,100,45,55,10
"1546",2017-07-08,134,47,87,100,34,66,10
"1547",2017-07-09,136,64,72,100,32,68,10
"1548",2017-07-10,127,42,85,100,32,68,10
"1549",2017-07-11,133,49,84,100,47,53,10
"1550",2017-07-12,157,68,89,100,44,56,10
"1551",2017-07-13,150,59,91,100,23,77,10
"1552",2017-07-14,135,45,90,100,37,63,10
"1553",2017-07-15,135,48,87,100,42,58,10
"1554",2017-07-16,134,43,91,100,31,69,10
"1555",2017-07-17,136,54,82,100,32,68,10
"1556",2017-07-18,145,52,93,100,21,79,10
"1557",2017-07-19,141,36,105,100,22,78,10
"1558",2017-07-20,134,43,91,100,26,74,10
"1559",2017-07-21,131,41,90,100,28,72,10
"1560",2017-07-22,147,41,106,100,31,69,10
"1561",2017-07-23,145,63,82,100,49,51,10
"1562",2017-07-24,132,38,94,100,32,68,10
"1563",2017-07-25,142,47,95,100,36,64,10
"1564",2017-07-26,162,82,80,100,46,54,10
"1565",2017-07-27,135,51,84,100,31,69,10
"1566",2017-07-28,137,75,62,100,57,43,10
"1567",2017-07-29,144,66,78,100,51,49,10
"1568",2017-07-30,132,58,74,100,41,59,10
"1569",2017-07-31,139,49,90,100,32,68,10
"1570",2017-08-01,136,68,68,100,50,50,10
"1571",2017-08-02,132,39,93,100,28,72,10
"1572",2017-08-03,127,34,93,100,34,66,10
"1573",2017-08-04,139,33,106,100,26,74,10
"1574",2017-08-05,135,52,83,100,33,67,10
"1575",2017-08-06,142,61,81,100,37,63,10
"1576",2017-08-07,131,42,89,100,46,54,10
"1577",2017-08-08,146,71,75,100,56,44,10
"1578",2017-08-09,141,45,96,100,39,61,10
"1579",2017-08-10,134,45,89,100,43,57,10
"1580",2017-08-11,135,60,75,100,46,54,10
"1581",2017-08-12,149,38,111,100,28,72,10
"1582",2017-08-13,137,49,88,100,38,62,10
"1583",2017-08-14,134,43,91,100,39,61,10
"1584",2017-08-15,140,60,80,100,37,63,10
"1585",2017-08-16,133,77,56,100,54,46,10
"1586",2017-08-17,134,55,79,100,45,55,10
"1587",2017-08-18,132,52,80,100,47,53,10
"1588",2017-08-19,136,63,73,100,47,53,10
"1589",2017-08-20,129,29,100,100,19,81,10
"1590",2017-08-21,135,43,92,100,31,69,10
"1591",2017-08-22,131,30,101,100,40,60,10
"1592",2017-08-23,128,42,86,100,39,61,10
"1593",2017-08-24,125,44,81,100,28,72,10
"1594",2017-08-25,151,29,122,100,23,77,10
"1595",2017-08-26,148,65,83,100,40,60,10
"1596",2017-08-27,125,26,99,100,23,77,10
"1597",2017-08-28,129,23,106,100,23,77,10
"1598",2017-08-29,142,43,99,100,28,72,10
"1599",2017-08-30,133,37,96,100,30,70,10
"1600",2017-08-31,135,55,80,100,40,60,10
