"","check_in_date","over_nbookings","over_canceled","over_booking_arrivals","over_same_phat","over_canceled_same_p","over_booking_arrivals_phat","booking_n","booking_canceled","booking_arrivals","iter"
"1",2017-03-25,149,61,88,129,64,88,100,44,56,1
"2",2017-03-26,127,44,83,129,34,83,100,28,72,1
"3",2017-03-27,122,16,106,129,23,106,100,22,78,1
"4",2017-03-28,125,32,93,129,24,93,100,18,82,1
"5",2017-03-29,120,20,100,129,32,100,100,14,86,1
"6",2017-03-30,151,62,89,129,53,89,100,40,60,1
"7",2017-03-31,152,64,88,129,62,88,100,52,48,1
"8",2017-04-01,126,47,79,129,65,79,100,36,64,1
"9",2017-04-02,126,22,104,129,23,104,100,19,81,1
"10",2017-04-03,151,70,81,129,54,81,100,35,65,1
"11",2017-04-04,212,143,69,129,90,69,100,60,40,1
"12",2017-04-05,156,75,81,129,61,81,100,46,54,1
"13",2017-04-06,222,149,73,129,79,73,100,56,44,1
"14",2017-04-07,126,57,69,129,59,69,100,44,56,1
"15",2017-04-08,131,73,58,129,57,58,100,52,48,1
"16",2017-04-09,158,76,82,129,70,82,100,54,46,1
"17",2017-04-10,127,56,71,129,45,71,100,37,63,1
"18",2017-04-11,128,34,94,129,27,94,100,26,74,1
"19",2017-04-12,132,57,75,129,56,75,100,44,56,1
"20",2017-04-13,144,74,70,129,63,70,100,60,40,1
"21",2017-04-14,126,60,66,129,62,66,100,43,57,1
"22",2017-04-15,163,108,55,129,72,55,100,68,32,1
"23",2017-04-16,141,69,72,129,68,72,100,53,47,1
"24",2017-04-17,127,52,75,129,45,75,100,31,69,1
"25",2017-04-18,134,51,83,129,56,83,100,53,47,1
"26",2017-04-19,122,28,94,129,38,94,100,24,76,1
"27",2017-04-20,144,65,79,129,59,79,100,51,49,1
"28",2017-04-21,171,102,69,129,84,69,100,49,51,1
"29",2017-04-22,245,179,66,129,95,66,100,68,32,1
"30",2017-04-23,164,71,93,129,54,93,100,49,51,1
"31",2017-04-24,125,27,98,129,37,98,100,23,77,1
"32",2017-04-25,142,48,94,129,37,94,100,40,60,1
"33",2017-04-26,248,187,61,129,98,61,100,75,25,1
"34",2017-04-27,160,84,76,129,61,76,100,47,53,1
"35",2017-04-28,126,54,72,129,51,72,100,36,64,1
"36",2017-04-29,148,87,61,129,78,61,100,55,45,1
"37",2017-04-30,126,36,90,129,42,90,100,32,68,1
"38",2017-05-01,145,70,75,129,64,75,100,39,61,1
"39",2017-05-02,124,41,83,129,33,83,100,25,75,1
"40",2017-05-03,182,133,49,129,87,49,100,67,33,1
"41",2017-05-04,191,118,73,129,81,73,100,60,40,1
"42",2017-05-05,141,71,70,129,62,70,100,50,50,1
"43",2017-05-06,166,95,71,129,72,71,100,57,43,1
"44",2017-05-07,126,44,82,129,47,82,100,41,59,1
"45",2017-05-08,145,84,61,129,78,61,100,56,44,1
"46",2017-05-09,144,51,93,129,48,93,100,36,64,1
"47",2017-05-10,133,58,75,129,59,75,100,44,56,1
"48",2017-05-11,137,59,78,129,54,78,100,39,61,1
"49",2017-05-12,130,57,73,129,52,73,100,46,54,1
"50",2017-05-13,154,76,78,129,67,78,100,39,61,1
"51",2017-05-14,116,26,90,129,18,90,100,14,86,1
"52",2017-05-15,248,192,56,129,103,56,100,74,26,1
"53",2017-05-16,129,54,75,129,65,75,100,54,46,1
"54",2017-05-17,124,39,85,129,35,85,100,41,59,1
"55",2017-05-18,131,53,78,129,53,78,100,36,64,1
"56",2017-05-19,240,179,61,129,98,61,100,75,25,1
"57",2017-05-20,148,83,65,129,65,65,100,55,45,1
"58",2017-05-21,125,41,84,129,47,84,100,41,59,1
"59",2017-05-22,128,47,81,129,45,81,100,36,64,1
"60",2017-05-23,140,49,91,129,39,91,100,29,71,1
"61",2017-05-24,133,65,68,129,70,68,100,48,52,1
"62",2017-05-25,158,62,96,129,62,96,100,38,62,1
"63",2017-05-26,143,75,68,129,58,68,100,36,64,1
"64",2017-05-27,130,56,74,129,53,74,100,34,66,1
"65",2017-05-28,173,87,86,129,62,86,100,49,51,1
"66",2017-05-29,128,39,89,129,31,89,100,26,74,1
"67",2017-05-30,232,156,76,129,84,76,100,70,30,1
"68",2017-05-31,142,57,85,129,58,85,100,39,61,1
"69",2017-06-01,158,79,79,129,59,79,100,54,46,1
"70",2017-06-02,150,61,89,129,64,89,100,43,57,1
"71",2017-06-03,154,59,95,129,54,95,100,50,50,1
"72",2017-06-04,151,51,100,129,56,100,100,40,60,1
"73",2017-06-05,123,33,90,129,43,90,100,32,68,1
"74",2017-06-06,132,49,83,129,44,83,100,29,71,1
"75",2017-06-07,174,92,82,129,78,82,100,45,55,1
"76",2017-06-08,191,118,73,129,91,73,100,71,29,1
"77",2017-06-09,162,80,82,129,56,82,100,53,47,1
"78",2017-06-10,125,43,82,129,44,82,100,33,67,1
"79",2017-06-11,140,58,82,129,37,82,100,47,53,1
"80",2017-06-12,149,65,84,129,45,84,100,40,60,1
"81",2017-06-13,141,46,95,129,45,95,100,34,66,1
"82",2017-06-14,176,73,103,129,41,103,100,45,55,1
"83",2017-06-15,148,54,94,129,47,94,100,44,56,1
"84",2017-06-16,148,64,84,129,61,84,100,49,51,1
"85",2017-06-17,214,135,79,129,82,79,100,71,29,1
"86",2017-06-18,130,40,90,129,41,90,100,35,65,1
"87",2017-06-19,158,77,81,129,52,81,100,45,55,1
"88",2017-06-20,130,53,77,129,49,77,100,41,59,1
"89",2017-06-21,168,90,78,129,70,78,100,59,41,1
"90",2017-06-22,127,43,84,129,45,84,100,30,70,1
"91",2017-06-23,167,83,84,129,67,84,100,43,57,1
"92",2017-06-24,161,79,82,129,51,82,100,53,47,1
"93",2017-06-25,146,21,125,129,13,125,100,13,87,1
"94",2017-06-26,166,86,80,129,61,80,100,53,47,1
"95",2017-06-27,141,65,76,129,55,76,100,56,44,1
"96",2017-06-28,152,69,83,129,74,83,100,56,44,1
"97",2017-06-29,129,63,66,129,60,66,100,54,46,1
"98",2017-06-30,153,66,87,129,52,87,100,48,52,1
"99",2017-07-01,149,58,91,129,41,91,100,36,64,1
"100",2017-07-02,132,39,93,129,51,93,100,41,59,1
"101",2017-07-03,136,45,91,129,44,91,100,33,67,1
"102",2017-07-04,153,29,124,129,29,124,100,21,79,1
"103",2017-07-05,143,82,61,129,75,61,100,60,40,1
"104",2017-07-06,130,37,93,129,36,93,100,28,72,1
"105",2017-07-07,135,65,70,129,61,70,100,40,60,1
"106",2017-07-08,134,39,95,129,44,95,100,37,63,1
"107",2017-07-09,154,71,83,129,64,83,100,41,59,1
"108",2017-07-10,130,48,82,129,52,82,100,29,71,1
"109",2017-07-11,134,41,93,129,51,93,100,42,58,1
"110",2017-07-12,169,63,106,129,51,106,100,36,64,1
"111",2017-07-13,151,37,114,129,30,114,100,28,72,1
"112",2017-07-14,133,49,84,129,54,84,100,44,56,1
"113",2017-07-15,136,59,77,129,40,77,100,34,66,1
"114",2017-07-16,136,37,99,129,42,99,100,21,79,1
"115",2017-07-17,138,69,69,129,46,69,100,40,60,1
"116",2017-07-18,144,47,97,129,34,97,100,26,74,1
"117",2017-07-19,144,29,115,129,23,115,100,24,76,1
"118",2017-07-20,134,48,86,129,49,86,100,39,61,1
"119",2017-07-21,129,40,89,129,39,89,100,34,66,1
"120",2017-07-22,147,39,108,129,34,108,100,33,67,1
"121",2017-07-23,166,80,86,129,46,86,100,48,52,1
"122",2017-07-24,130,40,90,129,35,90,100,23,77,1
"123",2017-07-25,151,57,94,129,46,94,100,34,66,1
"124",2017-07-26,171,78,93,129,67,93,100,46,54,1
"125",2017-07-27,136,56,80,129,46,80,100,36,64,1
"126",2017-07-28,146,74,72,129,70,72,100,58,42,1
"127",2017-07-29,151,74,77,129,60,77,100,42,58,1
"128",2017-07-30,130,43,87,129,42,87,100,35,65,1
"129",2017-07-31,138,50,88,129,53,88,100,36,64,1
"130",2017-08-01,143,58,85,129,61,85,100,41,59,1
"131",2017-08-02,132,33,99,129,50,99,100,32,68,1
"132",2017-08-03,127,42,85,129,54,85,100,33,67,1
"133",2017-08-04,139,45,94,129,37,94,100,34,66,1
"134",2017-08-05,136,64,72,129,58,72,100,29,71,1
"135",2017-08-06,135,48,87,129,44,87,100,33,67,1
"136",2017-08-07,132,46,86,129,49,86,100,32,68,1
"137",2017-08-08,148,63,85,129,67,85,100,49,51,1
"138",2017-08-09,141,43,98,129,47,98,100,44,56,1
"139",2017-08-10,132,47,85,129,53,85,100,37,63,1
"140",2017-08-11,133,58,75,129,52,75,100,45,55,1
"141",2017-08-12,142,50,92,129,36,92,100,32,68,1
"142",2017-08-13,133,50,83,129,55,83,100,33,67,1
"143",2017-08-14,135,42,93,129,42,93,100,38,62,1
"144",2017-08-15,150,72,78,129,45,78,100,35,65,1
"145",2017-08-16,137,83,54,129,68,54,100,60,40,1
"146",2017-08-17,135,43,92,129,56,92,100,43,57,1
"147",2017-08-18,133,64,69,129,57,69,100,50,50,1
"148",2017-08-19,144,67,77,129,58,77,100,46,54,1
"149",2017-08-20,127,34,93,129,25,93,100,26,74,1
"150",2017-08-21,139,46,93,129,38,93,100,33,67,1
"151",2017-08-22,131,42,89,129,41,89,100,38,62,1
"152",2017-08-23,125,41,84,129,33,84,100,31,69,1
"153",2017-08-24,125,39,86,129,39,86,100,43,57,1
"154",2017-08-25,151,35,116,129,32,116,100,26,74,1
"155",2017-08-26,149,46,103,129,41,103,100,46,54,1
"156",2017-08-27,127,32,95,129,34,95,100,29,71,1
"157",2017-08-28,128,20,108,129,28,108,100,26,74,1
"158",2017-08-29,145,37,108,129,46,108,100,35,65,1
"159",2017-08-30,132,37,95,129,32,95,100,33,67,1
"160",2017-08-31,132,47,85,129,51,85,100,30,70,1
"161",2017-03-25,148,66,82,129,69,82,100,48,52,2
"162",2017-03-26,125,29,96,129,21,96,100,21,79,2
"163",2017-03-27,120,27,93,129,29,93,100,17,83,2
"164",2017-03-28,126,29,97,129,30,97,100,26,74,2
"165",2017-03-29,120,15,105,129,19,105,100,16,84,2
"166",2017-03-30,138,44,94,129,50,94,100,29,71,2
"167",2017-03-31,151,68,83,129,62,83,100,50,50,2
"168",2017-04-01,126,46,80,129,46,80,100,45,55,2
"169",2017-04-02,126,20,106,129,25,106,100,21,79,2
"170",2017-04-03,150,59,91,129,52,91,100,46,54,2
"171",2017-04-04,199,120,79,129,71,79,100,69,31,2
"172",2017-04-05,152,77,75,129,69,75,100,45,55,2
"173",2017-04-06,221,140,81,129,81,81,100,62,38,2
"174",2017-04-07,126,46,80,129,53,80,100,43,57,2
"175",2017-04-08,130,55,75,129,67,75,100,54,46,2
"176",2017-04-09,165,89,76,129,55,76,100,53,47,2
"177",2017-04-10,125,51,74,129,47,74,100,40,60,2
"178",2017-04-11,129,35,94,129,32,94,100,26,74,2
"179",2017-04-12,131,45,86,129,55,86,100,43,57,2
"180",2017-04-13,148,76,72,129,64,72,100,43,57,2
"181",2017-04-14,126,51,75,129,53,75,100,50,50,2
"182",2017-04-15,162,113,49,129,84,49,100,64,36,2
"183",2017-04-16,153,83,70,129,74,70,100,51,49,2
"184",2017-04-17,128,42,86,129,40,86,100,36,64,2
"185",2017-04-18,146,68,78,129,59,78,100,45,55,2
"186",2017-04-19,122,40,82,129,31,82,100,32,68,2
"187",2017-04-20,147,66,81,129,53,81,100,43,57,2
"188",2017-04-21,154,89,65,129,93,65,100,61,39,2
"189",2017-04-22,240,179,61,129,94,61,100,72,28,2
"190",2017-04-23,163,74,89,129,60,89,100,41,59,2
"191",2017-04-24,124,36,88,129,36,88,100,26,74,2
"192",2017-04-25,152,53,99,129,46,99,100,30,70,2
"193",2017-04-26,279,216,63,129,110,63,100,69,31,2
"194",2017-04-27,161,90,71,129,77,71,100,53,47,2
"195",2017-04-28,125,49,76,129,49,76,100,48,52,2
"196",2017-04-29,155,100,55,129,80,55,100,69,31,2
"197",2017-04-30,125,38,87,129,43,87,100,32,68,2
"198",2017-05-01,153,74,79,129,62,79,100,48,52,2
"199",2017-05-02,123,34,89,129,38,89,100,23,77,2
"200",2017-05-03,172,118,54,129,90,54,100,61,39,2
"201",2017-05-04,199,126,73,129,84,73,100,67,33,2
"202",2017-05-05,136,64,72,129,61,72,100,45,55,2
"203",2017-05-06,164,86,78,129,63,78,100,57,43,2
"204",2017-05-07,128,53,75,129,52,75,100,42,58,2
"205",2017-05-08,137,65,72,129,72,72,100,49,51,2
"206",2017-05-09,144,52,92,129,39,92,100,29,71,2
"207",2017-05-10,127,45,82,129,56,82,100,30,70,2
"208",2017-05-11,139,52,87,129,48,87,100,42,58,2
"209",2017-05-12,129,57,72,129,52,72,100,35,65,2
"210",2017-05-13,149,70,79,129,59,79,100,35,65,2
"211",2017-05-14,117,24,93,129,19,93,100,14,86,2
"212",2017-05-15,228,164,64,129,90,64,100,67,33,2
"213",2017-05-16,136,56,80,129,64,80,100,38,62,2
"214",2017-05-17,122,32,90,129,45,90,100,29,71,2
"215",2017-05-18,138,52,86,129,47,86,100,44,56,2
"216",2017-05-19,227,166,61,129,95,61,100,75,25,2
"217",2017-05-20,157,89,68,129,75,68,100,57,43,2
"218",2017-05-21,125,41,84,129,35,84,100,35,65,2
"219",2017-05-22,130,55,75,129,63,75,100,45,55,2
"220",2017-05-23,138,44,94,129,53,94,100,38,62,2
"221",2017-05-24,132,53,79,129,62,79,100,43,57,2
"222",2017-05-25,169,65,104,129,59,104,100,41,59,2
"223",2017-05-26,147,70,77,129,63,77,100,51,49,2
"224",2017-05-27,130,44,86,129,59,86,100,39,61,2
"225",2017-05-28,166,81,85,129,63,85,100,45,55,2
"226",2017-05-29,123,24,99,129,26,99,100,30,70,2
"227",2017-05-30,234,161,73,129,79,73,100,67,33,2
"228",2017-05-31,143,59,84,129,54,84,100,32,68,2
"229",2017-06-01,165,90,75,129,64,75,100,61,39,2
"230",2017-06-02,161,81,80,129,66,80,100,37,63,2
"231",2017-06-03,153,57,96,129,45,96,100,36,64,2
"232",2017-06-04,155,51,104,129,43,104,100,40,60,2
"233",2017-06-05,123,40,83,129,37,83,100,35,65,2
"234",2017-06-06,135,48,87,129,46,87,100,30,70,2
"235",2017-06-07,172,93,79,129,68,79,100,50,50,2
"236",2017-06-08,226,160,66,129,89,66,100,66,34,2
"237",2017-06-09,170,86,84,129,48,84,100,47,53,2
"238",2017-06-10,124,41,83,129,39,83,100,28,72,2
"239",2017-06-11,137,51,86,129,51,86,100,46,54,2
"240",2017-06-12,148,56,92,129,57,92,100,45,55,2
"241",2017-06-13,137,42,95,129,49,95,100,28,72,2
"242",2017-06-14,173,70,103,129,47,103,100,31,69,2
"243",2017-06-15,137,38,99,129,49,99,100,43,57,2
"244",2017-06-16,152,70,82,129,59,82,100,54,46,2
"245",2017-06-17,206,129,77,129,75,77,100,57,43,2
"246",2017-06-18,131,49,82,129,52,82,100,28,72,2
"247",2017-06-19,156,64,92,129,56,92,100,42,58,2
"248",2017-06-20,141,60,81,129,63,81,100,39,61,2
"249",2017-06-21,156,86,70,129,75,70,100,49,51,2
"250",2017-06-22,128,52,76,129,41,76,100,33,67,2
"251",2017-06-23,174,104,70,129,66,70,100,61,39,2
"252",2017-06-24,158,74,84,129,64,84,100,56,44,2
"253",2017-06-25,145,19,126,129,22,126,100,14,86,2
"254",2017-06-26,160,83,77,129,66,77,100,54,46,2
"255",2017-06-27,141,68,73,129,58,73,100,46,54,2
"256",2017-06-28,168,78,90,129,63,90,100,57,43,2
"257",2017-06-29,130,65,65,129,61,65,100,51,49,2
"258",2017-06-30,153,61,92,129,52,92,100,47,53,2
"259",2017-07-01,151,60,91,129,44,91,100,33,67,2
"260",2017-07-02,129,44,85,129,39,85,100,35,65,2
"261",2017-07-03,133,35,98,129,42,98,100,27,73,2
"262",2017-07-04,152,24,128,129,30,128,100,21,79,2
"263",2017-07-05,143,78,65,129,71,65,100,68,32,2
"264",2017-07-06,133,48,85,129,32,85,100,34,66,2
"265",2017-07-07,134,73,61,129,68,61,100,47,53,2
"266",2017-07-08,136,33,103,129,40,103,100,36,64,2
"267",2017-07-09,154,77,77,129,57,77,100,50,50,2
"268",2017-07-10,130,44,86,129,49,86,100,38,62,2
"269",2017-07-11,136,48,88,129,50,88,100,43,57,2
"270",2017-07-12,173,71,102,129,42,102,100,41,59,2
"271",2017-07-13,154,37,117,129,41,117,100,21,79,2
"272",2017-07-14,129,40,89,129,40,89,100,43,57,2
"273",2017-07-15,135,51,84,129,49,84,100,44,56,2
"274",2017-07-16,131,43,88,129,37,88,100,28,72,2
"275",2017-07-17,136,52,84,129,62,84,100,32,68,2
"276",2017-07-18,153,51,102,129,39,102,100,35,65,2
"277",2017-07-19,141,29,112,129,26,112,100,19,81,2
"278",2017-07-20,136,56,80,129,50,80,100,42,58,2
"279",2017-07-21,128,29,99,129,35,99,100,26,74,2
"280",2017-07-22,146,46,100,129,35,100,100,39,61,2
"281",2017-07-23,170,77,93,129,58,93,100,53,47,2
"282",2017-07-24,130,48,82,129,44,82,100,40,60,2
"283",2017-07-25,150,53,97,129,44,97,100,36,64,2
"284",2017-07-26,176,82,94,129,55,94,100,49,51,2
"285",2017-07-27,132,41,91,129,42,91,100,42,58,2
"286",2017-07-28,152,89,63,129,63,63,100,59,41,2
"287",2017-07-29,156,73,83,129,56,83,100,44,56,2
"288",2017-07-30,132,52,80,129,50,80,100,37,63,2
"289",2017-07-31,137,49,88,129,39,88,100,32,68,2
"290",2017-08-01,143,69,74,129,55,74,100,44,56,2
"291",2017-08-02,133,39,94,129,36,94,100,30,70,2
"292",2017-08-03,128,56,72,129,46,72,100,28,72,2
"293",2017-08-04,139,44,95,129,43,95,100,36,64,2
"294",2017-08-05,138,42,96,129,45,96,100,37,63,2
"295",2017-08-06,138,52,86,129,49,86,100,30,70,2
"296",2017-08-07,132,43,89,129,45,89,100,36,64,2
"297",2017-08-08,156,74,82,129,67,82,100,50,50,2
"298",2017-08-09,139,52,87,129,54,87,100,38,62,2
"299",2017-08-10,134,65,69,129,54,69,100,37,63,2
"300",2017-08-11,134,54,80,129,62,80,100,46,54,2
"301",2017-08-12,142,55,87,129,40,87,100,33,67,2
"302",2017-08-13,134,45,89,129,46,89,100,35,65,2
"303",2017-08-14,131,45,86,129,50,86,100,40,60,2
"304",2017-08-15,143,55,88,129,47,88,100,43,57,2
"305",2017-08-16,135,79,56,129,72,56,100,46,54,2
"306",2017-08-17,136,51,85,129,59,85,100,53,47,2
"307",2017-08-18,134,66,68,129,48,68,100,50,50,2
"308",2017-08-19,143,63,80,129,50,80,100,52,48,2
"309",2017-08-20,129,27,102,129,30,102,100,20,80,2
"310",2017-08-21,136,40,96,129,37,96,100,32,68,2
"311",2017-08-22,130,37,93,129,38,93,100,32,68,2
"312",2017-08-23,127,36,91,129,36,91,100,25,75,2
"313",2017-08-24,125,40,85,129,37,85,100,29,71,2
"314",2017-08-25,150,37,113,129,27,113,100,36,64,2
"315",2017-08-26,144,46,98,129,44,98,100,36,64,2
"316",2017-08-27,124,34,90,129,30,90,100,18,82,2
"317",2017-08-28,128,22,106,129,24,106,100,23,77,2
"318",2017-08-29,145,46,99,129,43,99,100,32,68,2
"319",2017-08-30,133,37,96,129,31,96,100,24,76,2
"320",2017-08-31,130,48,82,129,53,82,100,35,65,2
